DEEP MAX,K,#Exec,PPV_S,PPV_NS,TPR_S,TPR_NS,F1_S,F1_NS,SUP_S,SUP_NS,TN,FP,FN,TP,Acc,Deep,Training Time
40,9,1,0.8022598870056498,0.7732997481108312,0.7593582887700535,0.8143236074270557,0.7802197802197803,0.7932816537467701,374,377,307,70,90,284,0.7869507323568575,40,11740.14576792717
40,3,1,0.7604938271604939,0.8034682080924855,0.8191489361702128,0.7413333333333333,0.7887323943661972,0.7711511789181692,376,375,278,97,68,308,0.7802929427430093,40,21064.982933282852
40,3,2,0.7918918918918919,0.7637795275590551,0.7650130548302873,0.7907608695652174,0.7782204515272244,0.7770360480640855,383,368,291,77,90,293,0.7776298268974701,39,28424.94531941414
40,7,1,0.8050139275766016,0.7908163265306123,0.7789757412398922,0.8157894736842105,0.7917808219178082,0.8031088082901554,371,380,310,70,82,289,0.7976031957390146,38,49734.22905135155
40,9,2,0.7769028871391076,0.7783783783783784,0.783068783068783,0.7721179624664879,0.7799736495388669,0.7752355316285329,378,373,288,85,82,296,0.7776298268974701,40,53576.94148039818
40,5,1,0.8115183246073299,0.8102981029810298,0.8157894736842105,0.8059299191374663,0.8136482939632546,0.8081081081081082,380,371,299,72,70,310,0.810918774966711,39,66432.41072511673
40,3,3,0.7666666666666667,0.7839335180055401,0.7931034482758621,0.7566844919786097,0.7796610169491527,0.7700680272108844,377,374,283,91,78,299,0.7749667110519307,36,26854.386496543884
40,7,2,0.7723785166240409,0.7861111111111111,0.7968337730870713,0.760752688172043,0.7844155844155843,0.7732240437158471,379,372,283,89,77,302,0.7789613848202397,40,30527.908188819885
40,3,4,0.7548543689320388,0.8053097345132744,0.8249336870026526,0.7299465240641712,0.788339670468948,0.7657784011220196,377,374,273,101,66,311,0.7776298268974701,40,31971.08916425705
40,5,2,0.8070175438596491,0.7628361858190709,0.739946380697051,0.8253968253968254,0.7720279720279721,0.7928843710292248,373,378,312,66,97,276,0.7829560585885486,40,47831.009333610535
40,7,3,0.7732997481108312,0.7966101694915254,0.8100263852242744,0.7580645161290323,0.7912371134020618,0.7768595041322315,379,372,282,90,72,307,0.7842876165113183,39,37169.542417526245
40,5,3,0.8108882521489972,0.763681592039801,0.7486772486772487,0.8230563002680965,0.7785419532324622,0.792258064516129,378,373,307,66,95,283,0.7856191744340879,40,20632.66465115547
40,9,3,0.7908163265306123,0.7938718662952646,0.8072916666666666,0.776566757493188,0.7989690721649486,0.7851239669421488,384,367,285,82,74,310,0.7922769640479361,32,71901.88880205154
40,3,5,0.7855227882037533,0.7804232804232805,0.7792553191489362,0.7866666666666666,0.7823765020026704,0.7835325365205844,376,375,295,80,83,293,0.7829560585885486,30,31121.679221868515
40,7,4,0.7932816537467701,0.8021978021978022,0.8100263852242744,0.7849462365591398,0.8015665796344648,0.7934782608695653,379,372,292,80,72,307,0.7976031957390146,37,33919.21024084091
40,3,6,0.7245657568238213,0.7586206896551724,0.776595744680851,0.704,0.7496790757381259,0.7302904564315353,376,375,264,111,84,292,0.7403462050599201,40,20476.053015947342
40,7,5,0.7944162436548223,0.8179271708683473,0.828042328042328,0.7828418230563002,0.8108808290155439,0.8,378,373,292,81,65,313,0.8055925432756325,38,16375.644634962082
40,3,7,0.7686170212765957,0.7786666666666666,0.7768817204301075,0.7704485488126649,0.7727272727272727,0.7745358090185676,372,379,292,87,83,289,0.7736351531291611,37,13912.115004062653
40,9,4,0.800524934383202,0.8027027027027027,0.8068783068783069,0.7962466487935657,0.8036890645586298,0.7994616419919247,378,373,297,76,73,305,0.8015978695073236,40,42943.73526406288
40,5,4,0.8010471204188482,0.8265582655826558,0.827027027027027,0.800524934383202,0.8138297872340425,0.8133333333333332,370,381,305,76,64,306,0.8135818908122503,39,46818.650449991226
40,9,5,0.7989130434782609,0.7911227154046997,0.786096256684492,0.8037135278514589,0.7924528301886793,0.7973684210526315,374,377,303,74,80,294,0.7949400798934754,40,14387.307134389877
40,7,6,0.828042328042328,0.8150134048257373,0.819371727748691,0.8238482384823849,0.8236842105263158,0.8194070080862533,382,369,304,65,69,313,0.8215712383488681,40,46023.07114601135
40,9,6,0.8119891008174387,0.796875,0.7925531914893617,0.816,0.8021534320323014,0.8063241106719369,376,375,306,69,78,298,0.8042609853528628,32,20959.99214053154
40,5,5,0.7769423558897243,0.8096590909090909,0.8222811671087533,0.7620320855614974,0.7989690721649484,0.7851239669421487,377,374,285,89,67,310,0.7922769640479361,34,42351.47496318817
40,3,8,0.7906976744186046,0.8021978021978022,0.8095238095238095,0.7828418230563002,0.8,0.7924016282225238,378,373,292,81,72,306,0.796271637816245,35,56363.43852472305
40,7,7,0.7596899224806202,0.7802197802197802,0.786096256684492,0.753315649867374,0.7726675427069646,0.766531713900135,374,377,284,93,80,294,0.7696404793608522,39,21130.03825378418
40,5,6,0.7817258883248731,0.7899159663865546,0.804177545691906,0.7663043478260869,0.7927927927927929,0.7779310344827587,383,368,282,86,75,308,0.7856191744340879,29,33140.43838143349
40,9,7,0.7471783295711061,0.827922077922078,0.8619791666666666,0.6948228882833788,0.8004836759371221,0.7555555555555555,384,367,255,112,53,331,0.7802929427430093,40,45431.11544418335
40,3,9,0.7506493506493507,0.7486338797814208,0.7585301837270341,0.7405405405405405,0.7545691906005222,0.7445652173913043,381,370,274,96,92,289,0.7496671105193076,40,31372.107207536697
40,3,10,0.7531486146095718,0.7627118644067796,0.7806788511749347,0.7336956521739131,0.7666666666666666,0.7479224376731303,383,368,270,98,84,299,0.7576564580559254,39,14551.70607161522
40,9,8,0.8048780487804879,0.8089005235602095,0.8027027027027027,0.8110236220472441,0.803788903924222,0.8099606815203145,370,381,309,72,73,297,0.8069241011984021,38,33907.44061040878
40,5,7,0.7929292929292929,0.8169014084507042,0.8284960422163589,0.7795698924731183,0.8103225806451614,0.797799174690509,379,372,290,82,65,314,0.8042609853528628,38,41159.91121125221
40,7,8,0.8370165745856354,0.8046272493573264,0.7994722955145118,0.8413978494623656,0.8178137651821862,0.8226018396846255,379,372,313,59,76,303,0.8202396804260985,33,95111.60605478287
40,5,8,0.7912087912087912,0.7803617571059431,0.7721179624664879,0.798941798941799,0.7815468113975577,0.7895424836601308,373,378,302,76,85,288,0.7856191744340879,32,46611.31246995926
40,9,9,0.7620320855614974,0.7559681697612732,0.7559681697612732,0.7620320855614974,0.7589880159786951,0.7589880159786951,377,374,285,89,92,285,0.758988015978695,36,52950.8822953701
40,7,9,0.7789757412398922,0.7789473684210526,0.774798927613941,0.783068783068783,0.7768817204301075,0.7810026385224274,373,378,296,82,84,289,0.7789613848202397,38,22363.7941262722
40,7,10,0.7905027932960894,0.7506361323155216,0.7427821522309711,0.7972972972972973,0.7658998646820027,0.7732634338138925,381,370,295,75,98,283,0.7696404793608522,35,36399.622806310654
40,5,9,0.821917808219178,0.8134715025906736,0.8064516129032258,0.8284960422163589,0.8141112618724559,0.8209150326797385,372,379,314,65,72,300,0.8175765645805593,38,48066.06864333153
40,9,10,0.7837078651685393,0.769620253164557,0.754054054054054,0.7979002624671916,0.768595041322314,0.7835051546391752,370,381,304,77,91,279,0.7762982689747004,24,45915.18758440018
40,5,10,0.782051282051282,0.8088642659279779,0.8155080213903744,0.7745358090185677,0.7984293193717278,0.7913279132791328,374,377,292,85,69,305,0.7949400798934754,35,31484.27615094185
