DEEP MAX,K,#Exec,PPV_S,PPV_NS,TPR_S,TPR_NS,F1_S,F1_NS,SUP_S,SUP_NS,TN,FP,FN,TP,Acc,Deep,Training Time
40,9,1,0.5976331360946746,0.9055823569951758,0.42436974789915966,0.9507959479015919,0.4963144963144963,0.9276385457112603,238,1382,1314,68,137,101,0.8734567901234568,32,15818.24990606308
40,7,1,0.6835443037974683,0.9124487004103967,0.4576271186440678,0.9638728323699421,0.5482233502538071,0.9374560787069571,236,1384,1334,50,128,108,0.8901234567901235,29,31631.29749059677
40,5,1,0.6339869281045751,0.8991138377641446,0.39591836734693875,0.9592727272727273,0.4874371859296483,0.9282195636875441,245,1375,1319,56,148,97,0.8740740740740741,39,40787.020208358765
40,9,2,0.6647398843930635,0.9156876295784382,0.48523206751054854,0.958062183658713,0.5609756097560976,0.9363957597173146,237,1383,1325,58,122,115,0.8888888888888888,33,28762.874037504196
40,3,1,0.717948717948718,0.9187158469945356,0.48484848484848486,0.9683225341972642,0.5788113695090439,0.9428671573781984,231,1389,1345,44,119,112,0.8993827160493827,39,49832.36168932915
40,7,2,0.6257309941520468,0.911663216011042,0.4553191489361702,0.9537906137184116,0.5270935960591133,0.9322512350035286,235,1385,1321,64,128,107,0.8814814814814815,34,20358.00935292244
40,3,2,0.5904255319148937,0.914804469273743,0.47639484978540775,0.9444844989185291,0.5273159144893111,0.9294075913444484,233,1387,1310,77,122,111,0.8771604938271605,39,24761.720115423203
40,9,3,0.7981651376146789,0.899404367968233,0.36401673640167365,0.9840695148443157,0.5,0.9398340248962656,239,1381,1359,22,152,87,0.8925925925925926,37,50003.80419445038
40,7,3,0.6645962732919255,0.9115832762165867,0.4533898305084746,0.9609826589595376,0.5390428211586903,0.9356313753077735,236,1384,1330,54,129,107,0.8870370370370371,31,62914.592948675156
40,3,3,0.5853658536585366,0.8990384615384616,0.3950617283950617,0.9506172839506173,0.4717444717444717,0.9241087186727851,243,1377,1309,68,147,96,0.8672839506172839,37,45078.9355969429
40,9,4,0.657608695652174,0.9178272980501393,0.5062761506276151,0.9543808834178131,0.5721040189125296,0.9357472488462905,239,1381,1318,63,118,121,0.8882716049382716,31,25430.025008916855
40,9,5,0.6623376623376623,0.907912687585266,0.43037974683544306,0.9624005784526392,0.5217391304347826,0.9343629343629343,237,1383,1331,52,135,102,0.8845679012345679,34,15580.431164503098
40,7,4,0.7482014388489209,0.9054692775151925,0.4262295081967213,0.9745639534883721,0.5430809399477806,0.9387469373468673,244,1376,1341,35,140,104,0.8919753086419753,33,25959.885002613068
40,5,2,0.7573529411764706,0.9097035040431267,0.4345991561181435,0.9761388286334056,0.5522788203753352,0.9417509591907918,237,1383,1350,33,134,103,0.8969135802469136,40,107201.09390091896
40,9,6,0.7450980392156863,0.9147920927062031,0.4769874476987448,0.9717595944967415,0.5816326530612245,0.9424157303370787,239,1381,1342,39,125,114,0.8987654320987655,34,31945.658538103104
40,7,5,0.5688622754491018,0.9008947006194081,0.39748953974895396,0.9478638667632151,0.46798029556650245,0.9237826393789698,239,1381,1309,72,144,95,0.8666666666666667,35,32385.728693008423
40,5,3,0.7018633540372671,0.9177518848526388,0.48497854077253216,0.9653929343907715,0.5736040609137055,0.9409697821503866,233,1387,1339,48,120,113,0.8962962962962963,40,37107.90083003044
40,7,6,0.7372262773722628,0.9055967633175994,0.4190871369294606,0.9738941261783901,0.5343915343915344,0.9385045422781272,241,1379,1343,36,140,101,0.891358024691358,34,16260.163163661957
40,9,7,0.7467532467532467,0.9133697135061392,0.47520661157024796,0.9716981132075472,0.5808080808080808,0.9416315049226442,242,1378,1339,39,127,115,0.8975308641975308,40,54154.06660223007
40,5,4,0.6894409937888198,0.9108978752570254,0.4605809128630705,0.9637418419144308,0.5522388059701492,0.9365750528541227,241,1379,1329,50,130,111,0.8888888888888888,21,50356.68536233902
40,7,7,0.7354838709677419,0.9119453924914676,0.4691358024691358,0.9702251270878722,0.5728643216080401,0.9401829697396199,243,1377,1336,41,129,114,0.8950617283950617,40,59980.56741309166
40,3,4,0.6804733727810651,0.9104066161268091,0.46938775510204084,0.9607272727272728,0.5555555555555557,0.934890304317056,245,1375,1321,54,130,115,0.8864197530864197,40,130044.95972633362
40,5,5,0.7037037037037037,0.9043771043771044,0.4008438818565401,0.9710773680404917,0.510752688172043,0.9365411436541143,237,1383,1343,40,142,95,0.8876543209876543,37,20330.355721473694
40,9,8,0.7258064516129032,0.9044117647058824,0.38626609442060084,0.9754866618601298,0.5042016806722689,0.9386056191467221,233,1387,1353,34,143,90,0.8907407407407407,38,44057.14590334892
40,5,6,0.5865921787709497,0.9035392088827203,0.430327868852459,0.9462209302325582,0.49645390070921996,0.9243876464323748,244,1376,1302,74,139,105,0.8685185185185185,31,24132.471516132355
40,7,8,0.6756756756756757,0.9089673913043478,0.42735042735042733,0.9653679653679653,0.5235602094240838,0.9363191042687193,234,1386,1338,48,134,100,0.8876543209876543,37,31321.928128242493
40,3,5,0.6273291925465838,0.90815627141878,0.4297872340425532,0.9566787003610109,0.51010101010101,0.9317862165963431,235,1385,1325,60,134,101,0.8802469135802469,40,32028.15997195244
40,9,9,0.7267441860465116,0.9212707182320442,0.5230125523012552,0.9659666908037654,0.6082725060827251,0.9430894308943091,239,1381,1334,47,114,125,0.9006172839506172,37,27504.4358587265
40,5,7,0.6285714285714286,0.9093425605536333,0.45643153526970953,0.9528643944887599,0.5288461538461539,0.9305949008498583,241,1379,1314,65,131,110,0.8790123456790123,38,26989.624474048615
40,3,6,0.6432748538011696,0.9151138716356108,0.4721030042918455,0.9560201874549387,0.5445544554455446,0.9351198871650211,233,1387,1326,61,123,110,0.8864197530864197,30,42235.43049788475
40,9,10,0.6839080459770115,0.9197786998616874,0.5063829787234042,0.9602888086642599,0.5819070904645476,0.9395973154362416,235,1385,1330,55,116,119,0.8944444444444445,38,49110.73912811279
40,3,7,0.5925925925925926,0.9091544374563243,0.4628099173553719,0.944121915820029,0.5197215777262181,0.926308294766821,242,1378,1301,77,130,112,0.8722222222222222,37,23743.35930109024
40,5,8,0.559322033898305,0.9071379071379071,0.4248927038626609,0.9437635183850036,0.4829268292682926,0.9250883392226149,233,1387,1309,78,134,99,0.8691358024691358,34,40882.24004364014
40,7,9,0.6808510638297872,0.9210893854748603,0.5311203319502075,0.9564902102973168,0.5967365967365967,0.9384560654571326,241,1379,1319,60,113,128,0.8932098765432098,40,69532.86014533043
40,3,8,0.6875,0.9136986301369863,0.4661016949152542,0.9638728323699421,0.5555555555555555,0.9381153305203938,236,1384,1334,50,126,110,0.891358024691358,29,53559.34049367905
40,7,10,0.622093023255814,0.9060773480662984,0.4403292181069959,0.9527959331880901,0.5156626506024096,0.928849557522124,243,1377,1312,65,136,107,0.8759259259259259,37,72503.50008559227
40,3,9,0.6369426751592356,0.9104579630895421,0.4329004329004329,0.958963282937365,0.5154639175257733,0.9340813464235624,231,1389,1332,57,131,100,0.8839506172839506,38,26685.13215303421
40,5,9,0.6845238095238095,0.9152892561983471,0.4831932773109244,0.9616497829232996,0.5665024630541872,0.9378969654199012,238,1382,1329,53,123,115,0.891358024691358,38,87474.13193154335
40,3,10,0.7517241379310344,0.9105084745762712,0.45228215767634855,0.9738941261783901,0.5647668393782384,0.9411352487736511,241,1379,1343,36,132,109,0.8962962962962963,40,30556.36495232582
40,5,10,0.6612021857923497,0.9178844815588031,0.5062761506276151,0.9551049963794352,0.5734597156398105,0.9361249112845991,239,1381,1319,62,118,121,0.8888888888888888,39,39681.61615562439
