K,Balanced,#Exec,PPV_S,PPV_NS,TPR_S,TPR_NS,F1_S,F1_NS,SUP_S,SUP_NS,TN,FP,FN,TP,Acc,AUC0,AUC1
3,1,0,0.227141482194,0.900089206066,0.67816091954,0.556843267108,0.340302811824,0.688032730992,348,1812,1009,803,112,236,0.576388888889,0.617502093324,0.617502093324
3,1,1,0.240740740741,0.908249158249,0.68221574344,0.593835993396,0.355893536122,0.718136439268,343,1817,1079,738,109,234,0.60787037037,0.638025868418,0.638025868418
3,1,2,0.226508407517,0.896431679721,0.658045977011,0.568432671082,0.337012509198,0.695710908477,348,1812,1030,782,119,229,0.58287037037,0.613239324047,0.613239324047
3,1,3,0.237907206318,0.905841325196,0.690544412607,0.573716178907,0.35389133627,0.702501690331,349,1811,1039,772,108,241,0.592592592593,0.632130295757,0.632130295757
3,1,4,0.222331047992,0.891132572432,0.646723646724,0.561083471531,0.330903790087,0.688602442334,351,1809,1015,794,124,227,0.575,0.603903559127,0.603903559127
3,1,5,0.246435845214,0.908319185059,0.691428571429,0.591160220994,0.363363363363,0.716198125837,350,1810,1070,740,108,242,0.607407407407,0.641294396212,0.641294396212
3,1,6,0.233046800382,0.914645103324,0.719764011799,0.559033498078,0.352092352092,0.693933197001,339,1821,1018,803,95,244,0.584259259259,0.639398754939,0.639398754939
3,1,7,0.222222222222,0.901234567901,0.702857142857,0.524309392265,0.337680164722,0.662940971009,350,1810,949,861,104,246,0.553240740741,0.613583267561,0.613583267561
3,1,8,0.238928939238,0.904121110177,0.670520231214,0.592613009923,0.3523158694,0.715950715951,346,1814,1075,739,114,232,0.605092592593,0.631566620568,0.631566620568
3,1,9,0.22990844354,0.895497026338,0.647564469914,0.581998895638,0.339339339339,0.705488621151,349,1811,1054,757,123,226,0.592592592593,0.614781682776,0.614781682776
3,1,10,0.230769230769,0.902730375427,0.666666666667,0.58195819582,0.342857142857,0.707692307692,342,1818,1058,760,114,228,0.59537037037,0.624312431243,0.624312431243
3,1,11,0.225324027916,0.895419187554,0.651296829971,0.571428571429,0.334814814815,0.697643097643,347,1813,1036,777,121,226,0.584259259259,0.6113627007,0.6113627007
3,1,12,0.219814241486,0.890848026868,0.620991253644,0.58392955421,0.324695121951,0.70545212766,343,1817,1061,756,130,213,0.589814814815,0.602460403927,0.602460403927
3,1,13,0.222222222222,0.897306397306,0.639053254438,0.585071350165,0.329770992366,0.708305647841,338,1822,1066,756,122,216,0.593518518519,0.612062302301,0.612062302301
3,1,14,0.228,0.897413793103,0.657060518732,0.574186431329,0.338530066815,0.700302724521,347,1813,1041,772,119,228,0.5875,0.615623475031,0.615623475031
3,1,15,0.229357798165,0.903307888041,0.663716814159,0.584843492586,0.340909090909,0.71,339,1821,1065,756,114,225,0.597222222222,0.624280153373,0.624280153373
3,1,16,0.240986717268,0.917721518987,0.736231884058,0.559228650138,0.363116511794,0.694967476891,345,1815,1015,800,91,254,0.5875,0.647730267098,0.647730267098
3,1,17,0.218289085546,0.893263342082,0.645348837209,0.562224669604,0.326230712711,0.690098006083,344,1816,1021,795,122,222,0.575462962963,0.603786753406,0.603786753406
3,1,18,0.232198142415,0.905121746432,0.665680473373,0.59165751921,0.344299923489,0.715565881182,338,1822,1078,744,113,225,0.603240740741,0.628668996291,0.628668996291
3,1,19,0.248447204969,0.908710217755,0.687679083095,0.599116510215,0.365019011407,0.722129783694,349,1811,1085,726,109,240,0.613425925926,0.643397796655,0.643397796655
3,1,20,0.228976697062,0.902813299233,0.664705882353,0.581868131868,0.340617935192,0.707651186101,340,1820,1059,761,114,226,0.594907407407,0.623287007111,0.623287007111
3,1,21,0.227713178295,0.905141843972,0.687134502924,0.561606160616,0.342066957787,0.693143245078,342,1818,1021,797,107,235,0.581481481481,0.62437033177,0.62437033177
3,1,22,0.233766233766,0.901639344262,0.672413793103,0.576710816777,0.346923647146,0.70346684618,348,1812,1045,767,114,234,0.59212962963,0.62456230494,0.62456230494
3,1,23,0.224510813594,0.895710681245,0.637426900585,0.585808580858,0.332063975628,0.70834718989,342,1818,1065,753,124,218,0.593981481481,0.611617740721,0.611617740721
3,1,24,0.22835394862,0.901713255185,0.687679083095,0.552181115406,0.342857142857,0.684931506849,349,1811,1000,811,109,240,0.574074074074,0.61993009925,0.61993009925
3,1,25,0.214570858283,0.888601036269,0.625,0.566629955947,0.319465081724,0.69199731002,344,1816,1029,787,129,215,0.575925925926,0.595814977974,0.595814977974
3,1,26,0.232799245994,0.911737943585,0.718023255814,0.551762114537,0.351601423488,0.687478559177,344,1816,1002,814,97,247,0.578240740741,0.634892685176,0.634892685176
3,1,27,0.235294117647,0.900662251656,0.651162790698,0.599118942731,0.345679012346,0.719576719577,344,1816,1088,728,120,224,0.607407407407,0.625140866714,0.625140866714
3,1,28,0.228712871287,0.907826086957,0.685459940653,0.572682391662,0.3429844098,0.702320887992,337,1823,1044,779,106,231,0.590277777778,0.629071166157,0.629071166157
3,1,29,0.233635448137,0.898029134533,0.660968660969,0.579325594251,0.345238095238,0.704301075269,351,1809,1048,761,119,232,0.592592592593,0.62014712761,0.62014712761
3,1,30,0.222546161322,0.899204244032,0.667638483965,0.559713813979,0.333819241983,0.689959294437,343,1817,1017,800,114,229,0.576851851852,0.613676148972,0.613676148972
3,1,31,0.225897920605,0.907441016334,0.700879765396,0.549752611325,0.341672623302,0.684697021568,341,1819,1000,819,102,239,0.573611111111,0.62531618836,0.62531618836
3,1,32,0.227502527806,0.900939368061,0.659824046921,0.579989004948,0.338345864662,0.705685618729,341,1819,1055,764,116,225,0.592592592593,0.619906525934,0.619906525934
3,1,33,0.232835820896,0.910822510823,0.694362017804,0.577070762479,0.348733233979,0.706514439221,337,1823,1052,771,103,234,0.59537037037,0.635716390142,0.635716390142
3,1,34,0.227761485826,0.903254177661,0.679300291545,0.565217391304,0.341142020498,0.695328368314,343,1817,1027,790,110,233,0.583333333333,0.622258841425,0.622258841425
3,1,35,0.235418875928,0.900575184881,0.6472303207,0.603192074849,0.345256609642,0.722478576137,343,1817,1096,721,121,222,0.610185185185,0.625211197774,0.625211197774
3,1,36,0.230105465005,0.907788719785,0.69970845481,0.558062740782,0.34632034632,0.691206543967,343,1817,1014,803,103,240,0.580555555556,0.628885597796,0.628885597796
3,1,37,0.22754491018,0.902417962003,0.66862170088,0.574491478835,0.339538346984,0.70204904266,341,1819,1045,774,113,228,0.589351851852,0.621556589857,0.621556589857
3,1,38,0.222551928783,0.904264577894,0.671641791045,0.569315068493,0.334323922734,0.698722259583,335,1825,1039,786,110,225,0.585185185185,0.620478429769,0.620478429769
3,1,39,0.228655544652,0.904469763365,0.681286549708,0.567656765677,0.342395297575,0.697532950321,342,1818,1032,786,109,233,0.585648148148,0.624471657692,0.624471657692
3,1,40,0.229850746269,0.905627705628,0.679411764706,0.574725274725,0.343494423792,0.703193277311,340,1820,1046,774,109,231,0.591203703704,0.627068519716,0.627068519716
3,1,41,0.218568665377,0.90053285968,0.668639053254,0.556531284303,0.32944606414,0.687924016282,338,1822,1014,808,112,226,0.574074074074,0.612585168779,0.612585168779
3,1,42,0.235294117647,0.896283491789,0.662921348315,0.574833702882,0.347314201619,0.700439040865,356,1804,1037,767,120,236,0.589351851852,0.618877525599,0.618877525599
3,1,43,0.240702479339,0.905201342282,0.673410404624,0.594818081588,0.354642313546,0.717897538257,346,1814,1079,735,113,233,0.607407407407,0.634114243106,0.634114243106
3,1,44,0.229411764706,0.90350877193,0.68023255814,0.56718061674,0.343108504399,0.696887686062,344,1816,1030,786,110,234,0.585185185185,0.62370658744,0.62370658744
3,1,45,0.223320158103,0.901567944251,0.666666666667,0.568369028007,0.334566987417,0.697204445941,339,1821,1035,786,113,226,0.583796296296,0.617517847337,0.617517847337
3,1,46,0.230769230769,0.900667779633,0.651026392962,0.59318306762,0.340752110514,0.715280079549,341,1819,1079,740,119,222,0.602314814815,0.622104730291,0.622104730291
3,1,47,0.236381322957,0.908127208481,0.700288184438,0.567015995587,0.353454545455,0.698132427844,347,1813,1028,785,104,243,0.588425925926,0.633652090013,0.633652090013
3,1,48,0.22860020141,0.892030848329,0.643059490085,0.576092971776,0.337295690936,0.700067249496,353,1807,1041,766,126,227,0.587037037037,0.609576230931,0.609576230931
3,1,49,0.218464351005,0.912757973734,0.719879518072,0.53227571116,0.335203366059,0.672425708362,332,1828,973,855,93,239,0.561111111111,0.626077614616,0.626077614616
3,1,50,0.234631147541,0.903716216216,0.667638483965,0.588882773803,0.347232752085,0.713095634788,343,1817,1070,747,114,229,0.601388888889,0.628260628884,0.628260628884
3,1,51,0.219537815126,0.901490066225,0.637195121951,0.59443231441,0.3265625,0.716447368421,328,1832,1089,743,119,209,0.600925925926,0.615813718181,0.615813718181
3,1,52,0.242708333333,0.900833333333,0.661931818182,0.597898230088,0.355182926829,0.71875,352,1808,1081,727,119,233,0.608333333333,0.629915024135,0.629915024135
3,1,53,0.229423868313,0.906565656566,0.667664670659,0.589813800657,0.341500765697,0.714664897147,334,1826,1077,749,111,223,0.601851851852,0.628739235658,0.628739235658
3,1,54,0.224202626642,0.898537477148,0.682857142857,0.543093922652,0.337570621469,0.676997245179,350,1810,983,827,111,239,0.565740740741,0.612975532755,0.612975532755
3,1,55,0.237755102041,0.897457627119,0.658192090395,0.586378737542,0.349325337331,0.709310113865,354,1806,1059,747,121,233,0.598148148148,0.622285413969,0.622285413969
3,1,56,0.231481481481,0.900673400673,0.655976676385,0.588882773803,0.342205323194,0.712146422629,343,1817,1070,747,118,225,0.599537037037,0.622429725094,0.622429725094
3,1,57,0.235741444867,0.919675090253,0.73590504451,0.558968732858,0.357091432685,0.695325827363,337,1823,1019,804,89,248,0.586574074074,0.647436888684,0.647436888684
3,1,58,0.230535894843,0.894961571307,0.649572649573,0.579325594251,0.340298507463,0.703355704698,351,1809,1048,761,123,228,0.590740740741,0.614449121912,0.614449121912
3,1,59,0.227091633466,0.900519031142,0.66472303207,0.57292239956,0.338530066815,0.700302724521,343,1817,1041,776,115,228,0.5875,0.618822715815,0.618822715815
3,1,60,0.229674796748,0.901360544218,0.66081871345,0.583058305831,0.340874811463,0.708082832331,342,1818,1060,758,116,226,0.59537037037,0.62193850964,0.62193850964
3,1,61,0.247724974722,0.907771135781,0.694050991501,0.588267847261,0.365126676602,0.713901947616,353,1807,1063,744,108,245,0.605555555556,0.641159419381,0.641159419381
3,1,62,0.240039840637,0.902249134948,0.680790960452,0.577519379845,0.354933726068,0.704253882512,354,1806,1043,763,113,241,0.594444444444,0.629155170148,0.629155170148
3,1,63,0.236,0.911206896552,0.69616519174,0.580450302032,0.352501867065,0.709158000671,339,1821,1057,764,103,236,0.598611111111,0.638307746886,0.638307746886
3,1,64,0.232,0.895689655172,0.657223796034,0.574986164914,0.342941611234,0.70037074486,353,1807,1039,768,121,232,0.588425925926,0.616104980474,0.616104980474
3,1,65,0.221238938053,0.902887139108,0.669642857143,0.565789473684,0.332594235033,0.695652173913,336,1824,1032,792,111,225,0.581944444444,0.617716165414,0.617716165414
3,1,66,0.228571428571,0.903056768559,0.67638483965,0.569069895432,0.341678939617,0.698176907495,343,1817,1034,783,111,232,0.586111111111,0.622727367541,0.622727367541
3,1,67,0.23353909465,0.899831649832,0.656069364162,0.589305402426,0.344461305008,0.712191872085,346,1814,1069,745,119,227,0.6,0.622687383294,0.622687383294
3,1,68,0.244136460554,0.908346972177,0.671554252199,0.610225398571,0.358092259578,0.730023018744,341,1819,1110,709,112,229,0.619907407407,0.640889825385,0.640889825385
3,1,69,0.234899328859,0.915846016115,0.722713864307,0.561779242175,0.354558610709,0.696392103472,339,1821,1023,798,94,245,0.587037037037,0.642246553241,0.642246553241
3,1,70,0.240196078431,0.908771929825,0.702005730659,0.57205963556,0.357925493061,0.702134869536,349,1811,1036,775,104,245,0.593055555556,0.63703268311,0.63703268311
3,1,71,0.223865877712,0.902268760908,0.669616519174,0.567819879187,0.335550628234,0.697000337041,339,1821,1034,787,112,227,0.583796296296,0.618718199181,0.618718199181
3,1,72,0.218479307026,0.904549509367,0.679640718563,0.555312157722,0.330662782229,0.688157448252,334,1826,1014,812,107,227,0.574537037037,0.617476438142,0.617476438142
3,1,73,0.215105162524,0.902154398564,0.673652694611,0.550383351588,0.326086956522,0.683673469388,334,1826,1005,821,109,225,0.569444444444,0.612018023099,0.612018023099
3,1,74,0.243133265514,0.909940526763,0.692753623188,0.590082644628,0.359939759036,0.715909090909,345,1815,1071,744,106,239,0.606481481481,0.641418133908,0.641418133908
3,1,75,0.231557377049,0.893581081081,0.642045454545,0.58517699115,0.340361445783,0.707219251337,352,1808,1058,750,126,226,0.594444444444,0.613611222848,0.613611222848
3,1,76,0.220138203356,0.904097646033,0.66966966967,0.567597153804,0.331352154532,0.69737726967,333,1827,1037,790,110,223,0.583333333333,0.618633411737,0.618633411737
3,1,77,0.238003838772,0.909660107335,0.710601719198,0.561568194368,0.356578001438,0.694434960737,349,1811,1017,794,101,248,0.585648148148,0.636084956783,0.636084956783
3,1,78,0.221674876847,0.893449781659,0.648414985591,0.564258135687,0.330396475771,0.69168356998,347,1813,1023,790,122,225,0.577777777778,0.606336560639,0.606336560639
3,1,79,0.231599607458,0.89833479404,0.670454545455,0.566924778761,0.344274252371,0.69515089861,352,1808,1025,783,116,236,0.583796296296,0.618689662108,0.618689662108
3,1,80,0.234864300626,0.901830282862,0.655976676385,0.596587782058,0.345887778632,0.718118582312,343,1817,1084,733,118,225,0.606018518519,0.626282229222,0.626282229222
3,1,81,0.223776223776,0.899050905953,0.656891495601,0.572842221001,0.333830104322,0.699798522498,341,1819,1042,777,117,224,0.586111111111,0.614866858301,0.614866858301
3,1,82,0.236926360726,0.905968928863,0.658753709199,0.607789358201,0.348508634223,0.727511490479,337,1823,1108,715,115,222,0.615740740741,0.6332715337,0.6332715337
3,1,83,0.239152371342,0.903336184773,0.677142857143,0.583425414365,0.353467561521,0.708962739174,350,1810,1056,754,113,237,0.598611111111,0.630284135754,0.630284135754
3,1,84,0.227600411946,0.896551724138,0.642441860465,0.587004405286,0.336121673004,0.709484193012,344,1816,1066,750,123,221,0.595833333333,0.614723132876,0.614723132876
3,1,85,0.230243902439,0.903083700441,0.682080924855,0.565049614112,0.344274252371,0.69515089861,346,1814,1025,789,110,236,0.583796296296,0.623565269484,0.623565269484
3,1,86,0.232604373757,0.903812824957,0.678260869565,0.574655647383,0.346410066617,0.702593465813,345,1815,1043,772,111,234,0.591203703704,0.626458258474,0.626458258474
3,1,87,0.23786407767,0.906194690265,0.698005698006,0.566058595909,0.354815351195,0.696835658387,351,1809,1024,785,106,245,0.5875,0.632032146958,0.632032146958
3,1,88,0.219801980198,0.898260869565,0.654867256637,0.567270730368,0.329132690882,0.695388757994,339,1821,1033,788,117,222,0.581018518519,0.611068993503,0.611068993503
3,1,89,0.22256097561,0.896258503401,0.642228739003,0.579439252336,0.330566037736,0.703839732888,341,1819,1054,765,122,219,0.589351851852,0.61083399567,0.61083399567
3,1,90,0.223711340206,0.894957983193,0.634502923977,0.585808580858,0.330792682927,0.708111702128,342,1818,1065,753,125,217,0.593518518519,0.610155752417,0.610155752417
3,1,91,0.229,0.899137931034,0.661849710983,0.574972436604,0.340267459138,0.701412239408,346,1814,1043,771,117,229,0.588888888889,0.618411073793,0.618411073793
3,1,92,0.225099601594,0.907439446367,0.678678678679,0.574165298303,0.338070306657,0.703318806571,333,1827,1049,778,107,226,0.590277777778,0.626421988491,0.626421988491
3,1,93,0.234262125903,0.904282115869,0.66568914956,0.592083562397,0.346564885496,0.71561461794,341,1819,1077,742,114,227,0.603703703704,0.628886355979,0.628886355979
3,1,94,0.2275390625,0.901408450704,0.675362318841,0.564187327824,0.340394448503,0.694002033209,345,1815,1024,791,112,233,0.581944444444,0.619774823332,0.619774823332
3,1,95,0.234482758621,0.910043668122,0.697947214076,0.572842221001,0.351032448378,0.70310391363,341,1819,1042,777,103,238,0.592592592593,0.635394717538,0.635394717538
3,1,96,0.229807692308,0.908928571429,0.700879765396,0.559648158329,0.346125995655,0.692752636951,341,1819,1018,801,102,239,0.581944444444,0.630263961862,0.630263961862
3,1,97,0.221574344023,0.902740937224,0.674556213018,0.560373216246,0.333577176298,0.691500169319,338,1822,1021,801,110,228,0.578240740741,0.617464714632,0.617464714632
3,1,98,0.224260958206,0.896522476675,0.643274853801,0.581408140814,0.332577475435,0.705372038705,342,1818,1057,761,122,220,0.591203703704,0.612341497308,0.612341497308
3,1,99,0.236464088398,0.900398406375,0.631268436578,0.620538165843,0.344051446945,0.734720416125,339,1821,1130,691,125,214,0.622222222222,0.625903301211,0.625903301211
5,1,0,0.256972111554,0.917820069204,0.730878186969,0.587161040398,0.38025055269,0.716166047924,353,1807,1061,746,95,258,0.610648148148,0.659019613684,0.659019613684
5,1,1,0.222333000997,0.898012100259,0.653958944282,0.571192963167,0.331845238095,0.698252688172,341,1819,1039,780,118,223,0.584259259259,0.612575953724,0.612575953724
5,1,2,0.23832221163,0.910891089109,0.716332378223,0.558807288791,0.35765379113,0.692676249144,349,1811,1012,799,99,250,0.584259259259,0.637569833507,0.637569833507
5,1,3,0.23818707811,0.912733748887,0.715942028986,0.564738292011,0.357452966715,0.69775357386,345,1815,1025,790,98,247,0.588888888889,0.640340160498,0.640340160498
5,1,4,0.25346112886,0.917280917281,0.702064896755,0.61504667765,0.372456964006,0.736357659435,339,1821,1120,701,101,238,0.628703703704,0.658555787202,0.658555787202
5,1,5,0.230392156863,0.906140350877,0.687134502924,0.568206820682,0.345080763583,0.698444895199,342,1818,1033,785,107,235,0.587037037037,0.627670661803,0.627670661803
5,1,6,0.242914979757,0.912116040956,0.69970845481,0.58833241607,0.360631104433,0.715289394446,343,1817,1069,748,103,240,0.606018518519,0.64402043544,0.64402043544
5,1,7,0.243469174504,0.909393183707,0.681286549708,0.601760176018,0.358737490377,0.724263488911,342,1818,1094,724,109,233,0.614351851852,0.641523362863,0.641523362863
5,1,8,0.243434343434,0.912820512821,0.702623906706,0.587782058338,0.361590397599,0.715098761299,343,1817,1068,749,102,241,0.606018518519,0.645202982522,0.645202982522
5,1,9,0.24487704918,0.907094594595,0.684813753582,0.593042517946,0.360754716981,0.717195325543,349,1811,1074,737,110,239,0.60787037037,0.638928135764,0.638928135764
5,1,10,0.232468780019,0.907059874888,0.699421965318,0.55953693495,0.348954578226,0.692124105012,346,1814,1015,799,104,242,0.581944444444,0.629479450134,0.629479450134
5,1,11,0.233267716535,0.905594405594,0.686956521739,0.570798898072,0.348273328435,0.700236566408,345,1815,1036,779,108,237,0.589351851852,0.628877709905,0.628877709905
5,1,12,0.233918128655,0.911816578483,0.705882352941,0.568131868132,0.351390922401,0.700067704807,340,1820,1034,786,100,240,0.589814814815,0.637007110537,0.637007110537
5,1,13,0.240124740125,0.910684474124,0.683431952663,0.598792535675,0.355384615385,0.722516556291,338,1822,1091,731,107,231,0.612037037037,0.641112244169,0.641112244169
5,1,14,0.242424242424,0.905892700088,0.698591549296,0.570637119114,0.359941944848,0.700203942896,355,1805,1030,775,107,248,0.591666666667,0.634614334205,0.634614334205
5,1,15,0.224880382775,0.913901345291,0.70996978852,0.557135046473,0.341569767442,0.692255434783,331,1829,1019,810,96,235,0.580555555556,0.633552417497,0.633552417497
5,1,16,0.24178154825,0.909613804437,0.674556213018,0.607574094402,0.355971896956,0.728529121422,338,1822,1107,715,110,228,0.618055555556,0.64106515371,0.64106515371
5,1,17,0.243301178992,0.909535452323,0.671597633136,0.612513721186,0.357199055862,0.732043292883,338,1822,1116,706,111,227,0.621759259259,0.642055677161,0.642055677161
5,1,18,0.218687872763,0.903812824957,0.664652567976,0.570256971022,0.329094988781,0.699296010727,331,1829,1043,786,111,220,0.584722222222,0.617454769499,0.617454769499
5,1,19,0.239532619279,0.917034421889,0.723529411765,0.570879120879,0.359912216533,0.703691161531,340,1820,1039,781,94,246,0.594907407407,0.647204266322,0.647204266322
5,1,20,0.239324726912,0.914137033825,0.708823529412,0.579120879121,0.357832219748,0.709048099563,340,1820,1054,766,99,241,0.599537037037,0.643972204266,0.643972204266
5,1,21,0.251231527094,0.92576419214,0.75,0.582417582418,0.376383763838,0.715008431703,340,1820,1060,760,85,255,0.608796296296,0.666208791209,0.666208791209
5,1,22,0.229445506692,0.904847396768,0.693641618497,0.555678059537,0.344827586207,0.688524590164,346,1814,1008,806,106,240,0.577777777778,0.624659839017,0.624659839017
5,1,23,0.245108135942,0.913372582002,0.697947214076,0.597031335899,0.362804878049,0.722074468085,341,1819,1086,733,103,238,0.612962962963,0.647489274988,0.647489274988
5,1,24,0.246794871795,0.911764705882,0.681415929204,0.612850082372,0.362352941176,0.733004926108,339,1821,1116,705,108,231,0.623611111111,0.647133005788,0.647133005788
5,1,25,0.238505747126,0.908602150538,0.709401709402,0.560530679934,0.356989247312,0.693333333333,351,1809,1014,795,102,249,0.584722222222,0.634966194668,0.634966194668
5,1,26,0.235877106046,0.90964378801,0.695906432749,0.575907590759,0.352331606218,0.705287975749,342,1818,1047,771,104,238,0.594907407407,0.635907011754,0.635907011754
5,1,27,0.23842364532,0.915283842795,0.713864306785,0.575507962658,0.357459379616,0.706675657451,339,1821,1048,773,97,242,0.597222222222,0.644686134721,0.644686134721
5,1,28,0.24,0.912931034483,0.703812316716,0.582188015393,0.357941834452,0.710976837865,341,1819,1059,760,101,240,0.601388888889,0.643000166054,0.643000166054
5,1,29,0.238347457627,0.90625,0.663716814159,0.605161998902,0.350740452065,0.72571616727,339,1821,1102,719,114,225,0.614351851852,0.63443940653,0.63443940653
5,1,30,0.235404896422,0.920765027322,0.741839762611,0.554580362041,0.35739814153,0.692228688805,337,1823,1011,812,87,250,0.583796296296,0.648210062326,0.648210062326
5,1,31,0.226534296029,0.907794676806,0.721264367816,0.527041942605,0.34478021978,0.666899441341,348,1812,955,857,97,251,0.558333333333,0.62415315521,0.62415315521
5,1,32,0.218009478673,0.908597285068,0.694864048338,0.54893384363,0.33189033189,0.684389911384,331,1829,1004,825,101,230,0.571296296296,0.621898945984,0.621898945984
5,1,33,0.241935483871,0.912671232877,0.701754385965,0.586358635864,0.359820089955,0.713998660415,342,1818,1066,752,102,240,0.60462962963,0.644056510914,0.644056510914
5,1,34,0.233038348083,0.903762029746,0.682997118156,0.569773855488,0.347507331378,0.698917456022,347,1813,1033,780,110,237,0.587962962963,0.626385486822,0.626385486822
5,1,35,0.245226130653,0.912446351931,0.705202312139,0.585997794928,0.363907531693,0.713662302786,346,1814,1063,751,102,244,0.605092592593,0.645600053534,0.645600053534
5,1,36,0.242105263158,0.913223140496,0.686567164179,0.605479452055,0.357976653696,0.728171334432,335,1825,1105,720,105,230,0.618055555556,0.646023308117,0.646023308117
5,1,37,0.238600212089,0.90879211175,0.669642857143,0.606359649123,0.351837372948,0.727392305163,336,1824,1106,718,111,225,0.616203703704,0.638001253133,0.638001253133
5,1,38,0.22441314554,0.900456621005,0.686781609195,0.544150110375,0.338287331918,0.678362573099,348,1812,986,826,109,239,0.56712962963,0.615465859785,0.615465859785
5,1,39,0.24154589372,0.916444444444,0.726744186047,0.567731277533,0.362581580856,0.701122067324,344,1816,1031,785,94,250,0.593055555556,0.64723773179,0.64723773179
5,1,40,0.242827868852,0.905405405405,0.679083094556,0.591938155715,0.357735849057,0.715859766277,349,1811,1072,739,112,237,0.606018518519,0.635510625135,0.635510625135
5,1,41,0.235567970205,0.917127071823,0.737609329446,0.548156301596,0.357092448836,0.68618670341,343,1817,996,821,90,253,0.578240740741,0.642882815521,0.642882815521
5,1,42,0.237185929648,0.907296137339,0.686046511628,0.58204845815,0.352501867065,0.709158000671,344,1816,1057,759,108,236,0.598611111111,0.634047484889,0.634047484889
5,1,43,0.239583333333,0.9075,0.674486803519,0.598680593733,0.353574173713,0.721430937396,341,1819,1089,730,111,230,0.610648148148,0.636583698626,0.636583698626
5,1,44,0.235348837209,0.919815668203,0.744117647059,0.548351648352,0.357597173145,0.687091222031,340,1820,998,822,87,253,0.579166666667,0.646234647705,0.646234647705
5,1,45,0.221189591078,0.90036900369,0.687861271676,0.538037486218,0.334739803094,0.673567977916,346,1814,976,838,108,238,0.562037037037,0.612949378947,0.612949378947
5,1,46,0.234664070107,0.910856134157,0.704678362573,0.567656765677,0.352081811541,0.699423924094,342,1818,1032,786,101,241,0.589351851852,0.636167564125,0.636167564125
5,1,47,0.235294117647,0.900923593619,0.658959537572,0.59151047409,0.346768060837,0.714143094842,346,1814,1073,741,118,228,0.602314814815,0.625235005831,0.625235005831
5,1,48,0.236,0.906034482759,0.684057971014,0.579063360882,0.35092936803,0.706554621849,345,1815,1051,764,109,236,0.595833333333,0.631560665948,0.631560665948
5,1,49,0.230843840931,0.914968999114,0.712574850299,0.565717415115,0.348717948718,0.699153976311,334,1826,1033,793,96,238,0.588425925926,0.639146132707,0.639146132707
5,1,50,0.240039840637,0.90830449827,0.694524495677,0.579150579151,0.356772760918,0.707308858201,347,1813,1050,763,106,241,0.597685185185,0.636837537414,0.636837537414
5,1,51,0.239019407559,0.914479254869,0.698507462687,0.591780821918,0.356164383562,0.718562874251,335,1825,1080,745,101,234,0.608333333333,0.645144142302,0.645144142302
5,1,52,0.243927125506,0.909556313993,0.694524495677,0.587975730833,0.361048689139,0.714237855946,347,1813,1066,747,106,241,0.605092592593,0.641250113255,0.641250113255
5,1,53,0.247225025227,0.912745936698,0.706051873199,0.588527302813,0.366218236173,0.715627095909,347,1813,1067,746,102,245,0.607407407407,0.647289588006,0.647289588006
5,1,54,0.249742002064,0.909319899244,0.691428571429,0.598342541436,0.366944655042,0.721759413529,350,1810,1083,727,108,242,0.613425925926,0.644885556433,0.644885556433
5,1,55,0.241237113402,0.915966386555,0.700598802395,0.596933187295,0.358895705521,0.722811671088,334,1826,1090,736,100,234,0.612962962963,0.648765994845,0.648765994845
5,1,56,0.239551478084,0.904156064461,0.675287356322,0.588300220751,0.353649360421,0.712805081912,348,1812,1066,746,113,235,0.602314814815,0.631793788536,0.631793788536
5,1,57,0.243902439024,0.921585903084,0.737463126844,0.574409665019,0.366568914956,0.707713125846,339,1821,1046,775,89,250,0.6,0.655936395931,0.655936395931
5,1,58,0.243323442136,0.912097476066,0.708933717579,0.57804743519,0.362297496318,0.707629979743,347,1813,1048,765,101,246,0.599074074074,0.643490576385,0.643490576385
5,1,59,0.228440366972,0.914953271028,0.732352941176,0.537912087912,0.348251748252,0.677508650519,340,1820,979,841,91,249,0.568518518519,0.635132514544,0.635132514544
5,1,60,0.239299610895,0.916077738516,0.721407624633,0.570093457944,0.35938641344,0.702812605896,341,1819,1037,782,95,246,0.593981481481,0.645750541289,0.645750541289
5,1,61,0.221193415638,0.90404040404,0.653495440729,0.586564718733,0.33051498847,0.711493872143,329,1831,1074,757,114,215,0.596759259259,0.620030079731,0.620030079731
5,1,62,0.230150753769,0.903004291845,0.669590643275,0.578657865787,0.342557965595,0.705330204492,342,1818,1052,766,113,229,0.593055555556,0.624124254531,0.624124254531
5,1,63,0.232727272727,0.918867924528,0.748538011696,0.535753575358,0.355062413315,0.676858929812,342,1818,974,844,86,256,0.569444444444,0.642145793527,0.642145793527
5,1,64,0.239193083573,0.917783735478,0.730205278592,0.564595931831,0.360347322721,0.699115044248,341,1819,1027,792,92,249,0.590740740741,0.647400605212,0.647400605212
5,1,65,0.233300099701,0.907519446845,0.686217008798,0.577240241891,0.348214285714,0.70564516129,341,1819,1050,769,107,234,0.594444444444,0.631728625344,0.631728625344
5,1,66,0.242487046632,0.903765690377,0.670487106017,0.596355604638,0.356164383562,0.718562874251,349,1811,1080,731,115,234,0.608333333333,0.633421355328,0.633421355328
5,1,67,0.231420507996,0.909753874202,0.713043478261,0.549862258953,0.349431818182,0.68543956044,345,1815,998,817,99,246,0.575925925926,0.631452868607,0.631452868607
5,1,68,0.245302713987,0.914309484193,0.695266272189,0.603183315038,0.362654320988,0.726851851852,338,1822,1099,723,103,235,0.617592592593,0.649224793614,0.649224793614
5,1,69,0.243949661181,0.923691215617,0.745562130178,0.571350164654,0.36761487965,0.706002034588,338,1822,1041,781,86,252,0.598611111111,0.658456147416,0.658456147416
5,1,70,0.226145038168,0.903776978417,0.688953488372,0.553414096916,0.340517241379,0.686475409836,344,1816,1005,811,107,237,0.575,0.621183792644,0.621183792644
5,1,71,0.235525024534,0.904469763365,0.687679083095,0.569850911099,0.350877192982,0.69918699187,349,1811,1032,779,109,240,0.588888888889,0.628764997097,0.628764997097
5,1,72,0.232427366448,0.91582799634,0.729411764706,0.55,0.352523098792,0.687263989015,340,1820,1001,819,92,248,0.578240740741,0.639705882353,0.639705882353
5,1,73,0.229044834308,0.909171075838,0.695266272189,0.56586169045,0.344574780059,0.697564276049,338,1822,1031,791,103,235,0.586111111111,0.63056398132,0.63056398132
5,1,74,0.234468937876,0.903614457831,0.676300578035,0.578831312018,0.348214285714,0.70564516129,346,1814,1050,764,112,234,0.594444444444,0.627565945026,0.627565945026
5,1,75,0.23031496063,0.902972027972,0.678260869565,0.56914600551,0.34386480529,0.698208854343,345,1815,1033,782,111,234,0.586574074074,0.623703437537,0.623703437537
5,1,76,0.247933884298,0.917785234899,0.710059171598,0.600439077936,0.367534456355,0.725945587259,338,1822,1094,728,98,240,0.617592592593,0.655249124767,0.655249124767
5,1,77,0.245867768595,0.901845637584,0.670422535211,0.595567867036,0.359788359788,0.717384050717,355,1805,1075,730,117,238,0.60787037037,0.632995201124,0.632995201124
5,1,78,0.237368922784,0.909090909091,0.711428571429,0.558011049724,0.355968548964,0.691543991784,350,1810,1010,800,101,249,0.58287037037,0.634719810576,0.634719810576
5,1,79,0.249027237354,0.918727915194,0.735632183908,0.573951434879,0.372093023256,0.70652173913,348,1812,1040,772,92,256,0.6,0.654791809393,0.654791809393
5,1,80,0.231064237776,0.911369740376,0.708823529412,0.559340659341,0.348517715112,0.693224378618,340,1820,1018,802,99,241,0.58287037037,0.634082094376,0.634082094376
5,1,81,0.232645403377,0.914990859232,0.727272727273,0.550302363936,0.352523098792,0.687263989015,341,1819,1001,818,93,248,0.578240740741,0.638787545604,0.638787545604
5,1,82,0.227053140097,0.904,0.685131195335,0.559713813979,0.341074020319,0.691366417403,343,1817,1017,800,108,235,0.57962962963,0.622422504657,0.622422504657
5,1,83,0.226455026455,0.901234567901,0.640718562874,0.599671412924,0.334636434715,0.720157842815,334,1826,1095,731,120,214,0.606018518519,0.620194987899,0.620194987899
5,1,84,0.219438877756,0.89156626506,0.634782608696,0.570798898072,0.326135517498,0.696002687269,345,1815,1036,779,126,219,0.581018518519,0.602790753384,0.602790753384
5,1,85,0.241791044776,0.916017316017,0.714705882353,0.581318681319,0.361338289963,0.711260504202,340,1820,1058,762,97,243,0.602314814815,0.648012281836,0.648012281836
5,1,86,0.234833659491,0.912126537786,0.705882352941,0.57032967033,0.352422907489,0.701825557809,340,1820,1038,782,100,240,0.591666666667,0.638106011635,0.638106011635
5,1,87,0.246767241379,0.913149350649,0.681547619048,0.616776315789,0.362341772152,0.736256544503,336,1824,1125,699,107,229,0.626851851852,0.649161967419,0.649161967419
5,1,88,0.225365853659,0.903964757709,0.679411764706,0.563736263736,0.338461538462,0.694416243655,340,1820,1026,794,109,231,0.581944444444,0.621574014221,0.621574014221
5,1,89,0.227984344423,0.902460456942,0.677325581395,0.565528634361,0.341142020498,0.695328368314,344,1816,1027,789,111,233,0.583333333333,0.621427107878,0.621427107878
5,1,90,0.220703125,0.904049295775,0.674626865672,0.562739726027,0.33259749816,0.693684566025,335,1825,1027,798,109,226,0.580092592593,0.61868329585,0.61868329585
5,1,91,0.234841193455,0.910793933988,0.709302325581,0.562224669604,0.352856109906,0.695267279537,344,1816,1021,795,100,244,0.585648148148,0.635763497592,0.635763497592
5,1,92,0.224783861671,0.907059874888,0.692307692308,0.557080131723,0.339376359681,0.690241414485,338,1822,1015,807,104,234,0.578240740741,0.624693912016,0.624693912016
5,1,93,0.238047808765,0.911764705882,0.700879765396,0.579439252336,0.355390334572,0.708571428571,341,1819,1054,765,102,239,0.598611111111,0.640159508866,0.640159508866
5,1,94,0.24375,0.905,0.672413793103,0.599337748344,0.357798165138,0.721115537849,348,1812,1086,726,114,234,0.611111111111,0.635875770724,0.635875770724
5,1,95,0.234580384226,0.900939368061,0.666666666667,0.582229580574,0.347045624533,0.707341602414,348,1812,1055,757,116,232,0.595833333333,0.62444812362,0.62444812362
5,1,96,0.225961538462,0.905357142857,0.689149560117,0.557449147883,0.340333091962,0.690030622661,341,1819,1014,805,106,235,0.578240740741,0.623299354,0.623299354
5,1,97,0.246994535519,0.902008032129,0.649425287356,0.619757174393,0.357878068092,0.73470722931,348,1812,1123,689,122,226,0.624537037037,0.634591230875,0.634591230875
5,1,98,0.248856358646,0.921274601687,0.76404494382,0.544900221729,0.375431331953,0.68477882271,356,1804,983,821,84,272,0.581018518519,0.654472582775,0.654472582775
5,1,99,0.239108409321,0.907928388747,0.686046511628,0.586453744493,0.354620586026,0.712612914018,344,1816,1065,751,108,236,0.602314814815,0.636250128061,0.636250128061
7,1,0,0.226277372263,0.903413821815,0.651651651652,0.593869731801,0.335913312693,0.716644649934,333,1827,1085,742,116,217,0.602777777778,0.622760691726,0.622760691726
7,1,1,0.227611940299,0.911764705882,0.717647058824,0.545054945055,0.345609065156,0.682255845942,340,1820,992,828,96,244,0.572222222222,0.631351001939,0.631351001939
7,1,2,0.240913811007,0.90977443609,0.682352941176,0.598351648352,0.356101304682,0.721909181306,340,1820,1089,731,108,232,0.611574074074,0.640352294764,0.640352294764
7,1,3,0.237154150198,0.907665505226,0.693641618497,0.574421168688,0.353460972018,0.703578663065,346,1814,1042,772,106,240,0.593518518519,0.634031393593,0.634031393593
7,1,4,0.245005257624,0.90570719603,0.671469740634,0.603971318257,0.359013867488,0.72468563865,347,1813,1095,718,114,233,0.614814814815,0.637720529446,0.637720529446
7,1,5,0.232177263969,0.909982174688,0.704678362573,0.561606160616,0.349275362319,0.694557823129,342,1818,1021,797,101,241,0.584259259259,0.633142261595,0.633142261595
7,1,6,0.229229229229,0.906115417743,0.677514792899,0.577387486279,0.342557965595,0.705330204492,338,1822,1052,770,109,229,0.593055555556,0.627451139589,0.627451139589
7,1,7,0.245067497404,0.90977443609,0.686046511628,0.599669603524,0.361132364193,0.722867573847,344,1816,1089,727,108,236,0.613425925926,0.642858057576,0.642858057576
7,1,8,0.237060041408,0.904522613065,0.667638483965,0.594386351128,0.349885408709,0.717369644636,343,1817,1080,737,114,229,0.606018518519,0.631012417547,0.631012417547
7,1,9,0.243538767396,0.909012131716,0.7,0.57955801105,0.361356932153,0.707827260459,350,1810,1049,761,105,245,0.599074074074,0.639779005525,0.639779005525
7,1,10,0.239244491081,0.908036454018,0.672566371681,0.601867105986,0.352941176471,0.723910171731,339,1821,1096,725,111,228,0.612962962963,0.637216738834,0.637216738834
7,1,11,0.244258872651,0.910149750416,0.684210526316,0.601760176018,0.36,0.724503311258,342,1818,1094,724,108,234,0.614814814815,0.642985351167,0.642985351167
7,1,12,0.221366698749,0.909901873327,0.694864048338,0.55768179333,0.335766423358,0.691525423729,331,1829,1020,809,101,230,0.578703703704,0.626272920834,0.626272920834
7,1,13,0.23385518591,0.910369068541,0.700879765396,0.569543705333,0.35069699193,0.700710179236,341,1819,1036,783,102,239,0.590277777778,0.635211735364,0.635211735364
7,1,14,0.222222222222,0.910927456382,0.710447761194,0.543561643836,0.338549075391,0.68085106383,335,1825,992,833,97,238,0.569444444444,0.627004702515,0.627004702515
7,1,15,0.225872689938,0.899662731872,0.648967551622,0.585941790225,0.33511043412,0.709677419355,339,1821,1067,754,119,220,0.595833333333,0.617454670924,0.617454670924
7,1,16,0.242366412214,0.923561151079,0.749262536873,0.563975837452,0.366258111031,0.700306853051,339,1821,1027,794,85,254,0.593055555556,0.656619187163,0.656619187163
7,1,17,0.239805825243,0.917699115044,0.726470588235,0.56978021978,0.360583941606,0.703050847458,340,1820,1037,783,93,247,0.594444444444,0.648125404008,0.648125404008
7,1,18,0.232919254658,0.902847571189,0.659824046921,0.592633315008,0.344299923489,0.715565881182,341,1819,1078,741,116,225,0.603240740741,0.626228680965,0.626228680965
7,1,19,0.2416918429,0.908311910883,0.691642651297,0.584666298952,0.358208955224,0.711409395973,347,1813,1060,753,107,240,0.601851851852,0.638154475124,0.638154475124
7,1,20,0.240740740741,0.912698412698,0.71387283237,0.570562293275,0.360058309038,0.702170963365,346,1814,1035,779,99,247,0.593518518519,0.642217562822,0.642217562822
7,1,21,0.243434343434,0.904273504274,0.682719546742,0.585500830105,0.358897989576,0.710782667115,353,1807,1058,749,112,241,0.601388888889,0.634110188424,0.634110188424
7,1,22,0.247524752475,0.906474820144,0.657894736842,0.623762376238,0.359712230216,0.739002932551,342,1818,1134,684,117,225,0.629166666667,0.64082855654,0.64082855654
7,1,23,0.248167539267,0.912033195021,0.690962099125,0.604843148046,0.365177195686,0.727332892124,343,1817,1099,718,106,237,0.618518518519,0.647902623586,0.647902623586
7,1,24,0.23976023976,0.904227782571,0.683760683761,0.579325594251,0.355029585799,0.706199460916,351,1809,1048,761,111,240,0.596296296296,0.631543139006,0.631543139006
7,1,25,0.230690010299,0.900756938604,0.654970760234,0.589108910891,0.341203351104,0.712337878284,342,1818,1071,747,118,224,0.599537037037,0.622039835563,0.622039835563
7,1,26,0.230694037146,0.906772207564,0.690058479532,0.567106710671,0.345787545788,0.697800338409,342,1818,1031,787,106,236,0.586574074074,0.628582595102,0.628582595102
7,1,27,0.241624365482,0.906382978723,0.683908045977,0.587748344371,0.357089272318,0.713090056913,348,1812,1065,747,110,238,0.603240740741,0.635828195174,0.635828195174
7,1,28,0.23126142596,0.904315196998,0.712676056338,0.534072022161,0.349206349206,0.671543016371,355,1805,964,841,102,253,0.563425925926,0.623374039249,0.623374039249
7,1,29,0.232749742533,0.906644238856,0.670623145401,0.591332967636,0.345565749235,0.715803452855,337,1823,1078,745,111,226,0.603703703704,0.630978056518,0.630978056518
7,1,30,0.227141482194,0.900981266726,0.680115273775,0.557087699945,0.340548340548,0.688479890934,347,1813,1010,803,111,236,0.576851851852,0.61860148686,0.61860148686
7,1,31,0.22342519685,0.899475524476,0.663742690058,0.56600660066,0.334315169367,0.694800810263,342,1818,1029,789,115,227,0.581481481481,0.614874645359,0.614874645359
7,1,32,0.244755244755,0.915444348576,0.714285714286,0.58392955421,0.364583333333,0.713037634409,343,1817,1061,756,98,245,0.60462962963,0.649107634248,0.649107634248
7,1,33,0.224318658281,0.892205638474,0.622093023256,0.592511013216,0.329738058552,0.712111184646,344,1816,1076,740,130,214,0.597222222222,0.607302018236,0.607302018236
7,1,34,0.229941291585,0.913005272408,0.703592814371,0.569003285871,0.346607669617,0.701079622132,334,1826,1039,787,99,235,0.589814814815,0.636298050121,0.636298050121
7,1,35,0.235586481113,0.915077989601,0.707462686567,0.578630136986,0.353467561521,0.708962739174,335,1825,1056,769,98,237,0.598611111111,0.643046411777,0.643046411777
7,1,36,0.233527131783,0.901595744681,0.684659090909,0.5625,0.348265895954,0.692779291553,352,1808,1017,791,111,241,0.582407407407,0.623579545455,0.623579545455
7,1,37,0.247011952191,0.911764705882,0.708571428571,0.582320441989,0.366322008863,0.710721510452,350,1810,1054,756,102,248,0.602777777778,0.64544593528,0.64544593528
7,1,38,0.23976023976,0.909404659189,0.695652173913,0.580716253444,0.35661218425,0.708809683927,345,1815,1054,761,105,240,0.599074074074,0.638184213678,0.638184213678
7,1,39,0.218871595331,0.897526501767,0.659824046921,0.558548653106,0.328707085464,0.688580142325,341,1819,1016,803,116,225,0.574537037037,0.609186350013,0.609186350013
7,1,40,0.227860696517,0.898701298701,0.661849710983,0.572216097023,0.339008142117,0.699225328393,346,1814,1038,776,117,229,0.586574074074,0.617032904003,0.617032904003
7,1,41,0.236947791165,0.908075601375,0.68804664723,0.58172812328,0.352501867065,0.709158000671,343,1817,1057,760,107,236,0.598611111111,0.634887385255,0.634887385255
7,1,42,0.245128205128,0.913924050633,0.700879765396,0.595382078065,0.363221884498,0.72103861518,341,1819,1083,736,102,239,0.612037037037,0.64813092173,0.64813092173
7,1,43,0.227751196172,0.912107623318,0.708333333333,0.557565789474,0.344677769732,0.692072133379,336,1824,1017,807,98,238,0.581018518519,0.632949561404,0.632949561404
7,1,44,0.225868725869,0.900355871886,0.676300578035,0.557883131202,0.338639652677,0.688904016338,346,1814,1012,802,112,234,0.576851851852,0.617091854618,0.617091854618
7,1,45,0.24693877551,0.916949152542,0.711764705882,0.594505494505,0.366666666667,0.721333333333,340,1820,1082,738,98,242,0.612962962963,0.653135100194,0.653135100194
7,1,46,0.238729508197,0.904560810811,0.673410404624,0.590407938258,0.352496217852,0.714476317545,346,1814,1071,743,113,233,0.603703703704,0.631909171441,0.631909171441
7,1,47,0.244491080797,0.908036454018,0.677325581395,0.603524229075,0.359290670779,0.725107509097,344,1816,1096,720,111,233,0.615277777778,0.640424905235,0.640424905235
7,1,48,0.225234619395,0.897585345545,0.637168141593,0.591982427238,0.33281972265,0.713434811383,339,1821,1078,743,123,216,0.599074074074,0.614575284415,0.614575284415
7,1,49,0.246246246246,0.902670111972,0.685236768802,0.581898945031,0.362297496318,0.707629979743,359,1801,1048,753,113,246,0.599074074074,0.633567856916,0.633567856916
7,1,50,0.234579439252,0.910091743119,0.719197707736,0.547763666483,0.353770260747,0.683902102723,349,1811,992,819,98,251,0.575462962963,0.633480687109,0.633480687109
7,1,51,0.218595450049,0.896431679721,0.65,0.565934065934,0.327165062916,0.693836308521,340,1820,1030,790,119,221,0.579166666667,0.607967032967,0.607967032967
7,1,52,0.257510729614,0.913680781759,0.693641618497,0.618522601985,0.37558685446,0.737672583826,346,1814,1122,692,106,240,0.630555555556,0.656082110241,0.656082110241
7,1,53,0.241967871486,0.908075601375,0.692528735632,0.583333333333,0.358630952381,0.710349462366,348,1812,1057,755,107,241,0.600925925926,0.637931034483,0.637931034483
7,1,54,0.237270875764,0.904923599321,0.675362318841,0.587327823691,0.351168048229,0.712328767123,345,1815,1066,749,112,233,0.601388888889,0.631345071266,0.631345071266
7,1,55,0.2265625,0.904049295775,0.680351906158,0.564595931831,0.339926739927,0.695093062606,341,1819,1027,792,109,232,0.58287037037,0.622473918995,0.622473918995
7,1,56,0.238729508197,0.907939189189,0.681286549708,0.591309130913,0.353566009105,0.716189207195,342,1818,1075,743,109,233,0.605555555556,0.63629784031,0.63629784031
7,1,57,0.239875389408,0.90559732665,0.671511627907,0.596916299559,0.353481254782,0.719548622635,344,1816,1084,732,113,231,0.608796296296,0.634213963733,0.634213963733
7,1,58,0.234939759036,0.904639175258,0.678260869565,0.580165289256,0.348993288591,0.706948640483,345,1815,1053,762,111,234,0.595833333333,0.629213079411,0.629213079411
7,1,59,0.237288135593,0.914389799636,0.728323699422,0.553472987872,0.357954545455,0.68956043956,346,1814,1004,810,94,252,0.581481481481,0.640898343647,0.640898343647
7,1,60,0.244712990937,0.905741216795,0.688385269122,0.584947426674,0.361069836553,0.710827168796,353,1807,1057,750,110,243,0.601851851852,0.636666347898,0.636666347898
7,1,61,0.236917221694,0.90441839495,0.701408450704,0.55567867036,0.354196301565,0.68840082361,355,1805,1003,802,106,249,0.57962962963,0.628543560532,0.628543560532
7,1,62,0.24,0.918061674009,0.725663716814,0.572213069742,0.360703812317,0.7050067659,339,1821,1042,779,93,246,0.596296296296,0.648938393278,0.648938393278
7,1,63,0.233170731707,0.901321585903,0.680911680912,0.565505804312,0.34738372093,0.694972826087,351,1809,1023,786,112,239,0.584259259259,0.623208742612,0.623208742612
7,1,64,0.239406779661,0.900493421053,0.651296829971,0.603971318257,0.350116189001,0.723010894685,347,1813,1095,718,121,226,0.611574074074,0.627634074114,0.627634074114
7,1,65,0.240040858018,0.907705334462,0.683139534884,0.590308370044,0.355253212396,0.715382048715,344,1816,1072,744,109,235,0.605092592593,0.636723952464,0.636723952464
7,1,66,0.228426395939,0.902978723404,0.663716814159,0.582646897309,0.339879154079,0.708277703605,339,1821,1061,760,114,225,0.59537037037,0.623181855734,0.623181855734
7,1,67,0.22090729783,0.903141361257,0.668656716418,0.567123287671,0.332097850259,0.696735106025,335,1825,1035,790,111,224,0.58287037037,0.617890002045,0.617890002045
7,1,68,0.243452958293,0.914968999114,0.723342939481,0.569773855488,0.364296081277,0.702243371856,347,1813,1033,780,96,251,0.594444444444,0.646558397485,0.646558397485
7,1,69,0.240334378265,0.90357439734,0.664739884393,0.599228224917,0.353031465848,0.720583360955,346,1814,1087,727,116,230,0.609722222222,0.631984054655,0.631984054655
7,1,70,0.242242242242,0.92075796727,0.724550898204,0.58543263965,0.363090772693,0.715768329428,334,1826,1069,757,92,242,0.606944444444,0.654991768927,0.654991768927
7,1,71,0.237252861602,0.90658882402,0.670588235294,0.597252747253,0.35049961568,0.720105995363,340,1820,1087,733,112,228,0.608796296296,0.633920491273,0.633920491273
7,1,72,0.215962441315,0.902283105023,0.682492581602,0.541963795941,0.328102710414,0.677176148047,337,1823,988,835,107,230,0.563888888889,0.612228188772,0.612228188772
7,1,73,0.228939544103,0.907037358818,0.683431952663,0.572996706915,0.3429844098,0.702320887992,338,1822,1044,778,107,231,0.590277777778,0.628214329789,0.628214329789
7,1,74,0.230097087379,0.913274336283,0.707462686567,0.565479452055,0.347252747253,0.69847715736,335,1825,1032,793,98,237,0.5875,0.636471069311,0.636471069311
7,1,75,0.234631147541,0.914695945946,0.693939393939,0.591803278689,0.350689127106,0.718646317186,330,1830,1083,747,101,229,0.607407407407,0.642871336314,0.642871336314
7,1,76,0.235127478754,0.916439600363,0.730205278592,0.554700384827,0.355714285714,0.691095890411,341,1819,1009,810,92,249,0.582407407407,0.64245283171,0.64245283171
7,1,77,0.23023023023,0.896640826873,0.657142857143,0.575138121547,0.340993328391,0.700774150118,350,1810,1041,769,120,230,0.588425925926,0.616140489345,0.616140489345
7,1,78,0.237322515213,0.913117546848,0.696428571429,0.587719298246,0.354009077156,0.715143428953,336,1824,1072,752,102,234,0.60462962963,0.642073934837,0.642073934837
7,1,79,0.242162162162,0.902024291498,0.649275362319,0.613774104683,0.352755905512,0.730491803279,345,1815,1114,701,121,224,0.619444444444,0.631524733501,0.631524733501
7,1,80,0.242548818088,0.904802021904,0.676217765043,0.593042517946,0.357034795764,0.716477651768,349,1811,1074,737,113,236,0.606481481481,0.634630141494,0.634630141494
7,1,81,0.225296442688,0.90331010453,0.672566371681,0.569467325645,0.337527757217,0.698551700909,339,1821,1037,784,111,228,0.585648148148,0.621016848663,0.621016848663
7,1,82,0.239919354839,0.911815068493,0.697947214076,0.585486531061,0.357089272318,0.713090056913,341,1819,1065,754,103,238,0.603240740741,0.641716872569,0.641716872569
7,1,83,0.238805970149,0.90589198036,0.660766961652,0.607907742998,0.350822239624,0.727571475518,339,1821,1107,714,115,224,0.616203703704,0.634337352325,0.634337352325
7,1,84,0.231472081218,0.914893617021,0.69512195122,0.586790393013,0.347296268088,0.714998337213,328,1832,1075,757,100,228,0.603240740741,0.640956172116,0.640956172116
7,1,85,0.246829268293,0.911894273128,0.71671388102,0.57277255119,0.367198838897,0.703602991162,353,1807,1035,772,100,253,0.596296296296,0.644743216105,0.644743216105
7,1,86,0.248190279214,0.9128248114,0.697674418605,0.599669603524,0.366132723112,0.723828514457,344,1816,1089,727,104,240,0.615277777778,0.648672011064,0.648672011064
7,1,87,0.263549415515,0.919606234619,0.71676300578,0.617971334068,0.385392385392,0.739202110122,346,1814,1121,693,98,248,0.633796296296,0.667367169924,0.667367169924
7,1,88,0.242273180459,0.910112359551,0.700288184438,0.580805295091,0.36,0.709090909091,347,1813,1053,760,104,243,0.6,0.640546739765,0.640546739765
7,1,89,0.236220472441,0.910839160839,0.701754385965,0.573157315732,0.353460972018,0.703578663065,342,1818,1042,776,102,240,0.593518518519,0.637455850848,0.637455850848
7,1,90,0.237338629593,0.913269731136,0.705014749263,0.578253706755,0.355126300149,0.708137188971,339,1821,1053,768,100,239,0.598148148148,0.641634228009,0.641634228009
7,1,91,0.233299075026,0.904802021904,0.667647058824,0.59010989011,0.345773038842,0.714333222481,340,1820,1074,746,113,227,0.602314814815,0.628878474467,0.628878474467
7,1,92,0.242609582059,0.911789652248,0.695906432749,0.591309130913,0.359788359788,0.717384050717,342,1818,1075,743,104,238,0.60787037037,0.643607781831,0.643607781831
7,1,93,0.244064577398,0.917795844625,0.738505747126,0.560706401766,0.366880799429,0.696128811237,348,1812,1016,796,91,257,0.589351851852,0.649606074446,0.649606074446
7,1,94,0.238747553816,0.907732864675,0.699140401146,0.570403092214,0.35594456601,0.700576466599,349,1811,1033,778,105,244,0.591203703704,0.63477174668,0.63477174668
7,1,95,0.247524752475,0.912173913043,0.712250712251,0.579878385849,0.367376928729,0.709023318689,351,1809,1049,760,101,250,0.601388888889,0.64606454905,0.64606454905
7,1,96,0.241902834008,0.907849829352,0.688760806916,0.586872586873,0.358052434457,0.712897822446,347,1813,1064,749,108,239,0.603240740741,0.637816696895,0.637816696895
7,1,97,0.243902439024,0.91156462585,0.697674418605,0.590308370044,0.361445783133,0.716577540107,344,1816,1072,744,104,240,0.607407407407,0.643991394324,0.643991394324
7,1,98,0.246865959499,0.916295636687,0.731428571429,0.568508287293,0.369142033165,0.701670644391,350,1810,1029,781,94,256,0.594907407407,0.649968429361,0.649968429361
7,1,99,0.251336898396,0.90612244898,0.671428571429,0.613259668508,0.365758754864,0.731466227348,350,1810,1110,700,115,235,0.622685185185,0.642344119968,0.642344119968
9,1,0,0.235649546828,0.908311910883,0.686217008798,0.582737768004,0.350824587706,0.709979906229,341,1819,1060,759,107,234,0.599074074074,0.634477388401,0.634477388401
9,1,1,0.239239239239,0.913867355728,0.705014749263,0.582646897309,0.357249626308,0.71160295104,339,1821,1061,760,100,239,0.601851851852,0.643830823286,0.643830823286
9,1,2,0.237948717949,0.91223628692,0.690476190476,0.592653508772,0.353928299008,0.718511133267,336,1824,1081,743,104,232,0.60787037037,0.641564849624,0.641564849624
9,1,3,0.21308411215,0.9,0.676557863501,0.538123971476,0.324093816631,0.673532440783,337,1823,981,842,109,228,0.559722222222,0.607340917489,0.607340917489
9,1,4,0.245087900724,0.911986588433,0.69298245614,0.598459845985,0.362108479756,0.722683493856,342,1818,1088,730,105,237,0.613425925926,0.645721151062,0.645721151062
9,1,5,0.234567901235,0.902356902357,0.662790697674,0.590308370044,0.346504559271,0.713715046605,344,1816,1072,744,116,228,0.601851851852,0.626549533859,0.626549533859
9,1,6,0.227095516569,0.903880070547,0.681286549708,0.563806380638,0.340643274854,0.694444444444,342,1818,1025,793,109,233,0.582407407407,0.622546465173,0.622546465173
9,1,7,0.2351160444,0.906757912746,0.681286549708,0.583058305831,0.349587396849,0.709742216271,342,1818,1060,758,109,233,0.598611111111,0.632172427769,0.632172427769
9,1,8,0.223264540338,0.899451553931,0.683908045977,0.543046357616,0.336633663366,0.677219545767,348,1812,984,828,110,238,0.565740740741,0.613477201796,0.613477201796
9,1,9,0.229475766568,0.906875543951,0.684365781711,0.572213069742,0.343703703704,0.701683501684,339,1821,1042,779,107,232,0.589814814815,0.628289425726,0.628289425726
9,1,10,0.230552952202,0.91582799634,0.727810650888,0.549396267838,0.350177935943,0.68679245283,338,1822,1001,821,92,246,0.577314814815,0.638603459363,0.638603459363
9,1,11,0.222772277228,0.901739130435,0.665680473373,0.569154774973,0.333827893175,0.697846567968,338,1822,1037,785,113,225,0.584259259259,0.617417624173,0.617417624173
9,1,12,0.232902033272,0.907235621521,0.715909090909,0.54092920354,0.351464435146,0.677754677755,352,1808,978,830,100,252,0.569444444444,0.628419147224,0.628419147224
9,1,13,0.236994219653,0.91265597148,0.71511627907,0.563876651982,0.356005788712,0.697072838666,344,1816,1024,792,98,246,0.587962962963,0.639496465526,0.639496465526
9,1,14,0.237394957983,0.914735099338,0.686930091185,0.603495357728,0.352849336456,0.72721289898,329,1831,1105,726,103,226,0.616203703704,0.645212724457,0.645212724457
9,1,15,0.234543670265,0.91148115688,0.702941176471,0.571428571429,0.351729212656,0.702465383316,340,1820,1040,780,101,239,0.59212962963,0.63718487395,0.63718487395
9,1,16,0.224086870681,0.896251089799,0.656069364162,0.566703417861,0.334069168506,0.694360013509,346,1814,1028,786,119,227,0.581018518519,0.611386391011,0.611386391011
9,1,17,0.223310479922,0.915715539947,0.703703703704,0.568082788671,0.339033457249,0.701176470588,324,1836,1043,793,96,228,0.588425925926,0.635893246187,0.635893246187
9,1,18,0.230917874396,0.910222222222,0.702941176471,0.562637362637,0.347636363636,0.695415959253,340,1820,1024,796,101,239,0.584722222222,0.632789269554,0.632789269554
9,1,19,0.232323232323,0.902564102564,0.668604651163,0.581497797357,0.344827586207,0.707300736772,344,1816,1056,760,114,230,0.59537037037,0.62505122426,0.62505122426
9,1,20,0.234756097561,0.909863945578,0.685459940653,0.586944596818,0.349735049205,0.713571190397,337,1823,1070,753,106,231,0.602314814815,0.636202268736,0.636202268736
9,1,21,0.230991337825,0.908117752007,0.69970845481,0.560264171712,0.347322720695,0.692988427502,343,1817,1018,799,103,240,0.582407407407,0.629986313261,0.629986313261
9,1,22,0.233846153846,0.902953586498,0.66472303207,0.588882773803,0.34597875569,0.712858094604,343,1817,1070,747,115,228,0.600925925926,0.626802902936,0.626802902936
9,1,23,0.232876712329,0.90916597853,0.667673716012,0.601968288682,0.3453125,0.724342105263,331,1829,1101,728,110,221,0.612037037037,0.634821002347,0.634821002347
9,1,24,0.24201853759,0.905803195963,0.677233429395,0.594043022614,0.35660091047,0.717521652232,347,1813,1077,736,112,235,0.607407407407,0.635638226005,0.635638226005
9,1,25,0.228739002933,0.91380826737,0.704819277108,0.568380743982,0.345387453875,0.70084317032,332,1828,1039,789,98,234,0.589351851852,0.636600010545,0.636600010545
9,1,26,0.232649071359,0.911169744943,0.702064896755,0.568918176826,0.349486049927,0.700473292765,339,1821,1036,785,101,238,0.589814814815,0.635491536791,0.635491536791
9,1,27,0.223350253807,0.908936170213,0.672782874618,0.582651391162,0.335365853659,0.710106382979,327,1833,1068,765,107,220,0.596296296296,0.62771713289,0.62771713289
9,1,28,0.230406043437,0.902815622162,0.695156695157,0.549474847982,0.34609929078,0.683161512027,351,1809,994,815,107,244,0.573148148148,0.62231577157,0.62231577157
9,1,29,0.240532241556,0.912933220626,0.695266272189,0.59275521405,0.357414448669,0.718801996672,338,1822,1080,742,103,235,0.608796296296,0.64401074312,0.64401074312
9,1,30,0.238383838384,0.917948717949,0.710843373494,0.587527352298,0.357034795764,0.716477651768,332,1828,1074,754,96,236,0.606481481481,0.649185362896,0.649185362896
9,1,31,0.246520874751,0.914211438475,0.71469740634,0.581908439051,0.366592756837,0.711156049882,347,1813,1055,758,99,248,0.603240740741,0.648302922696,0.648302922696
9,1,32,0.24593716143,0.910266774454,0.671597633136,0.61800219539,0.360031720856,0.736188296829,338,1822,1126,696,111,227,0.626388888889,0.644799914263,0.644799914263
9,1,33,0.232774674115,0.910681399632,0.720461095101,0.545504688362,0.351864883885,0.682304242842,347,1813,989,824,97,250,0.573611111111,0.632982891731,0.632982891731
9,1,34,0.220848056537,0.917315175097,0.746268656716,0.516712328767,0.340831629175,0.661058534876,335,1825,943,882,85,250,0.552314814815,0.631490492742,0.631490492742
9,1,35,0.227362204724,0.899475524476,0.667630057803,0.567254685777,0.339207048458,0.695740365112,346,1814,1029,785,115,231,0.583333333333,0.61744237179,0.61744237179
9,1,36,0.238894373149,0.90235396687,0.683615819209,0.573089700997,0.354059985369,0.70098205215,354,1806,1035,771,112,242,0.591203703704,0.628352760103,0.628352760103
9,1,37,0.245754245754,0.919758412425,0.725663716814,0.585392641406,0.367164179104,0.715436241611,339,1821,1066,755,93,246,0.607407407407,0.65552817911,0.65552817911
9,1,38,0.236499068901,0.917127071823,0.738372093023,0.54845814978,0.358251057828,0.686423156444,344,1816,996,820,90,254,0.578703703704,0.643415121401,0.643415121401
9,1,39,0.234101382488,0.906976744186,0.717514124294,0.539867109635,0.353022932592,0.676848316557,354,1806,975,831,100,254,0.568981481481,0.628690616964,0.628690616964
9,1,40,0.21442687747,0.905052264808,0.665644171779,0.566521264995,0.324364723468,0.696847753186,326,1834,1039,795,109,217,0.581481481481,0.616082718387,0.616082718387
9,1,41,0.219441770934,0.896520963426,0.662790697674,0.553414096916,0.329718004338,0.684371807967,344,1816,1005,811,116,228,0.570833333333,0.608102397295,0.608102397295
9,1,42,0.23185483871,0.902397260274,0.668604651163,0.580396475771,0.344311377246,0.706434316354,344,1816,1054,762,114,230,0.594444444444,0.624500563467,0.624500563467
9,1,43,0.236180904523,0.917596566524,0.70996978852,0.584472389284,0.354449472097,0.714094856379,331,1829,1069,760,96,235,0.603703703704,0.647221088902,0.647221088902
9,1,44,0.225409836066,0.910472972973,0.674846625767,0.587786259542,0.337941628264,0.714380384361,326,1834,1078,756,106,220,0.600925925926,0.631316442654,0.631316442654
9,1,45,0.235127478754,0.909173478656,0.713467048711,0.552733296521,0.353693181818,0.6875,349,1811,1001,810,100,249,0.578703703704,0.633100172616,0.633100172616
9,1,46,0.224173553719,0.897651006711,0.6401179941,0.587589236683,0.332058148432,0.710255559243,339,1821,1070,751,122,217,0.595833333333,0.613853615392,0.613853615392
9,1,47,0.230699364214,0.91029272899,0.727793696275,0.532302595251,0.350344827586,0.671777003484,349,1811,964,847,95,254,0.563888888889,0.630048145763,0.630048145763
9,1,48,0.235412474849,0.909090909091,0.688235294118,0.582417582418,0.350824587706,0.709979906229,340,1820,1060,760,106,234,0.599074074074,0.635326438268,0.635326438268
9,1,49,0.2407960199,0.909956709957,0.699421965318,0.579382579934,0.358253145818,0.707982485685,346,1814,1051,763,104,242,0.598611111111,0.639402272626,0.639402272626
9,1,50,0.230472516876,0.913624220837,0.71130952381,0.5625,0.348142753095,0.69630132338,336,1824,1026,798,97,239,0.585648148148,0.636904761905,0.636904761905
9,1,51,0.236212278876,0.904086738949,0.663742690058,0.596259625963,0.348426707598,0.718594630428,342,1818,1084,734,115,227,0.606944444444,0.630001158011,0.630001158011
9,1,52,0.24219590958,0.906580016247,0.661764705882,0.613186813187,0.354609929078,0.731563421829,340,1820,1116,704,115,225,0.620833333333,0.637475759535,0.637475759535
9,1,53,0.236538461538,0.908928571429,0.706896551724,0.561810154525,0.35446685879,0.694406548431,348,1812,1018,794,102,246,0.585185185185,0.634353353125,0.634353353125
9,1,54,0.233918128655,0.907407407407,0.695652173913,0.56694214876,0.35010940919,0.697863682604,345,1815,1029,786,105,240,0.5875,0.631297161337,0.631297161337
9,1,55,0.243099787686,0.910509031199,0.677514792899,0.608671789243,0.3578125,0.729605263158,338,1822,1109,713,109,229,0.619444444444,0.643093291071,0.643093291071
9,1,56,0.238046795524,0.909090909091,0.686217008798,0.588235294118,0.353474320242,0.714285714286,341,1819,1070,749,107,234,0.603703703704,0.637226151458,0.637226151458
9,1,57,0.239805825243,0.914159292035,0.718023255814,0.568832599119,0.359534206696,0.701289884589,344,1816,1033,783,97,247,0.592592592593,0.643427927466,0.643427927466
9,1,58,0.234791889007,0.905151267375,0.654761904762,0.606907894737,0.345640219953,0.726616343945,336,1824,1107,717,116,220,0.614351851852,0.630834899749,0.630834899749
9,1,59,0.23598820059,0.909886264217,0.69970845481,0.572372041827,0.352941176471,0.702702702703,343,1817,1040,777,103,240,0.592592592593,0.636040248319,0.636040248319
9,1,60,0.23842364532,0.912663755459,0.707602339181,0.574807480748,0.356669123066,0.705366182923,342,1818,1045,773,100,242,0.595833333333,0.641204909965,0.641204909965
9,1,61,0.238761238761,0.905090595341,0.684813753582,0.579237990061,0.354074074074,0.706397306397,349,1811,1049,762,110,239,0.596296296296,0.632025871821,0.632025871821
9,1,62,0.241803278689,0.909628378378,0.68804664723,0.592735277931,0.357846853677,0.717760746418,343,1817,1077,740,107,236,0.60787037037,0.64039096258,0.64039096258
9,1,63,0.250814332248,0.912832929782,0.681415929204,0.621087314662,0.366666666667,0.739215686275,339,1821,1131,690,108,231,0.630555555556,0.651251621933,0.651251621933
9,1,64,0.236263736264,0.916666666667,0.743515850144,0.53998896856,0.358582348853,0.679625130163,347,1813,979,834,89,258,0.572685185185,0.641752409352,0.641752409352
9,1,65,0.217641418984,0.909579230081,0.692073170732,0.554585152838,0.331145149526,0.689047134622,328,1832,1016,816,101,227,0.575462962963,0.623329161785,0.623329161785
9,1,66,0.236071765817,0.905540417802,0.706214689266,0.552048726467,0.353857041755,0.685930512556,354,1806,997,809,104,250,0.577314814815,0.629131707866,0.629131707866
9,1,67,0.233018867925,0.915454545455,0.726470588235,0.553296703297,0.352857142857,0.689726027397,340,1820,1007,813,93,247,0.580555555556,0.639883645766,0.639883645766
9,1,68,0.227272727273,0.904085257549,0.685131195335,0.560264171712,0.341321713871,0.691811077132,343,1817,1018,799,108,235,0.580092592593,0.622697683523,0.622697683523
9,1,69,0.232038834951,0.902654867257,0.684813753582,0.563224737714,0.346627991298,0.693641618497,349,1811,1020,791,110,239,0.58287037037,0.624019245648,0.624019245648
9,1,70,0.219885277247,0.905745062837,0.686567164179,0.552876712329,0.333091962346,0.686628104798,335,1825,1009,816,105,230,0.573611111111,0.619721938254,0.619721938254
9,1,71,0.232954545455,0.908514492754,0.708933717579,0.553226696084,0.350677120456,0.687692835105,347,1813,1003,810,101,246,0.578240740741,0.631080206832,0.631080206832
9,1,72,0.235059760956,0.912629757785,0.700296735905,0.578716401536,0.351976137211,0.708291372944,337,1823,1055,768,101,236,0.597685185185,0.63950656872,0.63950656872
9,1,73,0.236399604352,0.912097476066,0.702941176471,0.575824175824,0.353811991118,0.705961603233,340,1820,1048,772,101,239,0.595833333333,0.639382676147,0.639382676147
9,1,74,0.258823529412,0.909387755102,0.685552407932,0.616491422247,0.375776397516,0.734828496042,353,1807,1114,693,111,242,0.627777777778,0.651021915089,0.651021915089
9,1,75,0.227272727273,0.911190053286,0.701492537313,0.562191780822,0.343316289262,0.69535750593,335,1825,1026,799,100,235,0.583796296296,0.631842159068,0.631842159068
9,1,76,0.249471458774,0.897858319605,0.655555555556,0.605555555556,0.361408882083,0.723291307233,360,1800,1090,710,124,236,0.613888888889,0.630555555556,0.630555555556
9,1,77,0.220560747664,0.897247706422,0.67816091954,0.539735099338,0.332863187588,0.674017918677,348,1812,978,834,112,236,0.562037037037,0.608948009439,0.608948009439
9,1,78,0.242990654206,0.920183486239,0.749279538905,0.553226696084,0.366972477064,0.691009300723,347,1813,1003,810,87,260,0.584722222222,0.651253117494,0.651253117494
9,1,79,0.234833659491,0.906854130053,0.693641618497,0.568908489526,0.350877192982,0.69918699187,346,1814,1032,782,106,240,0.588888888889,0.631275054012,0.631275054012
9,1,80,0.227408142999,0.902862098873,0.671554252199,0.572292468389,0.339762611276,0.700538358008,341,1819,1041,778,112,229,0.587962962963,0.621923360294,0.621923360294
9,1,81,0.237672583826,0.923211169284,0.732522796353,0.577826324413,0.358897989576,0.710782667115,329,1831,1058,773,88,241,0.601388888889,0.655174560383,0.655174560383
9,1,82,0.232,0.90775862069,0.684365781711,0.578253706755,0.346527259149,0.706474337471,339,1821,1053,768,107,232,0.594907407407,0.631309744233,0.631309744233
9,1,83,0.226814516129,0.906678082192,0.673652694611,0.57995618839,0.339366515837,0.707414829659,334,1826,1059,767,109,225,0.594444444444,0.6268044415,0.6268044415
9,1,84,0.236814891417,0.898575020956,0.654285714286,0.59226519337,0.347760060744,0.713952713953,350,1810,1072,738,121,229,0.602314814815,0.623275453828,0.623275453828
9,1,85,0.230079681275,0.909169550173,0.6875,0.576206140351,0.344776119403,0.705369127517,336,1824,1051,773,105,231,0.593518518519,0.631853070175,0.631853070175
9,1,86,0.230479774224,0.914311759344,0.722713864307,0.550796265788,0.349500713267,0.68745716244,339,1821,1003,818,94,245,0.577777777778,0.636755065047,0.636755065047
9,1,87,0.228678537957,0.912168344007,0.717647058824,0.547802197802,0.34683724236,0.684517679368,340,1820,997,823,96,244,0.574537037037,0.632724628313,0.632724628313
9,1,88,0.244071146245,0.912891986063,0.71181556196,0.57804743519,0.363502575423,0.707868963188,347,1813,1048,765,100,247,0.599537037037,0.644931498575,0.644931498575
9,1,89,0.229508196721,0.911843276937,0.706231454006,0.561711464619,0.346433770015,0.695179904956,337,1823,1024,799,99,238,0.584259259259,0.633971459312,0.633971459312
9,1,90,0.221495327103,0.918348623853,0.726993865031,0.545801526718,0.339541547278,0.684678522572,326,1834,1001,833,89,237,0.573148148148,0.636397695874,0.636397695874
9,1,91,0.260540540541,0.922267206478,0.715133531157,0.624794295118,0.381933438986,0.744931327665,337,1823,1139,684,96,241,0.638888888889,0.669963913138,0.669963913138
9,1,92,0.25,0.913120567376,0.724719101124,0.570953436807,0.371757925072,0.702592087312,356,1804,1030,774,98,258,0.596296296296,0.647836268965,0.647836268965
9,1,93,0.235236220472,0.90034965035,0.677053824363,0.570005534034,0.349159970782,0.698068451372,353,1807,1030,777,114,239,0.5875,0.623529679198,0.623529679198
9,1,94,0.22722820764,0.908691834943,0.690476190476,0.567434210526,0.34193072955,0.698616267297,336,1824,1035,789,104,232,0.586574074074,0.628955200501,0.628955200501
9,1,95,0.234207968902,0.913351016799,0.710914454277,0.567270730368,0.352339181287,0.699864498645,339,1821,1033,788,98,241,0.589814814815,0.639092592323,0.639092592323
9,1,96,0.251068376068,0.90522875817,0.669515669516,0.612493090105,0.36519036519,0.730629739532,351,1809,1108,701,116,235,0.621759259259,0.64100437981,0.64100437981
9,1,97,0.239408866995,0.914410480349,0.712609970674,0.575590984057,0.358407079646,0.706477732794,341,1819,1047,772,98,243,0.597222222222,0.644100477366,0.644100477366
9,1,98,0.23654822335,0.904680851064,0.675362318841,0.585674931129,0.35037593985,0.711036789298,345,1815,1063,752,112,233,0.6,0.630518624985,0.630518624985
9,1,99,0.231225296443,0.908536585366,0.690265486726,0.572762218561,0.346410066617,0.702593465813,339,1821,1043,778,105,234,0.591203703704,0.631513852643,0.631513852643
11,1,0,0.234541577825,0.901800327332,0.647058823529,0.605494505495,0.344287949922,0.724523339908,340,1820,1102,718,120,220,0.612037037037,0.626276664512,0.626276664512
11,1,1,0.22474977252,0.916116870877,0.735119047619,0.532894736842,0.34425087108,0.673830155979,336,1824,972,852,89,247,0.564351851852,0.634006892231,0.634006892231
11,1,2,0.242395437262,0.913357400722,0.726495726496,0.559425096739,0.363506771205,0.69386355845,351,1809,1012,797,96,255,0.586574074074,0.642960411617,0.642960411617
11,1,3,0.250980392157,0.918421052632,0.733524355301,0.57813362783,0.373995617239,0.709589969502,349,1811,1047,764,93,256,0.603240740741,0.655828991565,0.655828991565
11,1,4,0.238469087341,0.921998247152,0.731927710843,0.575492341357,0.359733530718,0.708656113169,332,1828,1052,776,89,243,0.599537037037,0.6537100261,0.6537100261
11,1,5,0.230113636364,0.907608695652,0.704347826087,0.552066115702,0.346895074946,0.686536485098,345,1815,1002,813,102,243,0.576388888889,0.628206970895,0.628206970895
11,1,6,0.236097560976,0.91013215859,0.703488372093,0.568832599119,0.353542731921,0.700101660454,344,1816,1033,783,102,242,0.590277777778,0.636160485606,0.636160485606
11,1,7,0.227,0.911206896552,0.687878787879,0.577595628415,0.341353383459,0.707023411371,330,1830,1057,773,103,227,0.594444444444,0.632737208147,0.632737208147
11,1,8,0.24,0.916379310345,0.712166172107,0.583104772353,0.359012715034,0.712705330204,337,1823,1063,760,97,240,0.603240740741,0.64763547223,0.64763547223
11,1,9,0.230464886251,0.911227154047,0.69552238806,0.573698630137,0.346210995542,0.704102219233,335,1825,1047,778,102,233,0.592592592593,0.634610509098,0.634610509098
11,1,10,0.228952772074,0.903035413153,0.659763313609,0.587815587267,0.33993902439,0.71210106383,338,1822,1071,751,115,223,0.599074074074,0.623789450438,0.623789450438
11,1,11,0.236790606654,0.903339191564,0.6875,0.568584070796,0.352256186317,0.69789545146,352,1808,1028,780,110,242,0.587962962963,0.628042035398,0.628042035398
11,1,12,0.217830882353,0.908582089552,0.707462686567,0.533698630137,0.333099086437,0.672419744563,335,1825,974,851,98,237,0.560648148148,0.620580658352,0.620580658352
11,1,13,0.24975024975,0.919758412425,0.728862973761,0.586681342873,0.372023809524,0.716397849462,343,1817,1066,751,93,250,0.609259259259,0.657772158317,0.657772158317
11,1,14,0.241521068859,0.910699241786,0.689149560117,0.594282572842,0.357686453577,0.719228210246,341,1819,1081,738,106,235,0.609259259259,0.64171606648,0.64171606648
11,1,15,0.242203742204,0.904006677796,0.669540229885,0.597682119205,0.35572519084,0.719601328904,348,1812,1083,729,115,233,0.609259259259,0.633611174545,0.633611174545
11,1,16,0.230410447761,0.90625,0.707736389685,0.54445057979,0.347642505278,0.680234563643,349,1811,986,825,102,247,0.570833333333,0.626093484737,0.626093484737
11,1,17,0.242757242757,0.911993097498,0.704347826087,0.582369146006,0.361069836553,0.710827168796,345,1815,1057,758,102,243,0.601851851852,0.643358486046,0.643358486046
11,1,18,0.230105465005,0.914950760967,0.716417910448,0.56,0.348330914369,0.69476546567,335,1825,1022,803,95,240,0.584259259259,0.638208955224,0.638208955224
11,1,19,0.243902439024,0.907970419063,0.672514619883,0.607810781078,0.357976653696,0.728171334432,342,1818,1105,713,112,230,0.618055555556,0.640162700481,0.640162700481
11,1,20,0.238558909445,0.917917034422,0.724852071006,0.570801317234,0.358974358974,0.703891708968,338,1822,1040,782,93,245,0.594907407407,0.64782669412,0.64782669412
11,1,21,0.240740740741,0.909090909091,0.684210526316,0.594059405941,0.356164383562,0.718562874251,342,1818,1080,738,108,234,0.608333333333,0.639134966128,0.639134966128
11,1,22,0.233680227058,0.917497733454,0.730769230769,0.555433589462,0.354121863799,0.691965811966,338,1822,1012,810,91,247,0.58287037037,0.643101410116,0.643101410116
11,1,23,0.244,0.910344827586,0.701149425287,0.582781456954,0.362017804154,0.710632570659,348,1812,1056,756,104,244,0.601851851852,0.64196544112,0.64196544112
11,1,24,0.22984244671,0.905642923219,0.708571428571,0.540883977901,0.347095871239,0.67727429955,350,1810,979,831,102,248,0.568055555556,0.624727703236,0.624727703236
11,1,25,0.255020080321,0.920962199313,0.734104046243,0.590959206174,0.378539493294,0.719946272666,346,1814,1072,742,92,254,0.613888888889,0.662531626208,0.662531626208
11,1,26,0.249512670565,0.915343915344,0.727272727273,0.574115044248,0.371552975327,0.705642420122,352,1808,1038,770,96,256,0.599074074074,0.65069388576,0.65069388576
11,1,27,0.226145038168,0.908273381295,0.699115044248,0.554640307523,0.341744772891,0.688714626662,339,1821,1010,811,102,237,0.577314814815,0.626877675886,0.626877675886
11,1,28,0.234517766497,0.910638297872,0.6875,0.586622807018,0.349735049205,0.713571190397,336,1824,1070,754,105,231,0.602314814815,0.637061403509,0.637061403509
11,1,29,0.234989648033,0.905360134003,0.667647058824,0.593956043956,0.347626339969,0.717319177173,340,1820,1081,739,113,227,0.605555555556,0.63080155139,0.63080155139
11,1,30,0.243027888446,0.915224913495,0.713450292398,0.58195819582,0.362555720654,0.711499663753,342,1818,1058,760,98,244,0.602777777778,0.647704244109,0.647704244109
11,1,31,0.24557956778,0.92119089317,0.735294117647,0.578021978022,0.368188512518,0.710330857529,340,1820,1052,768,90,250,0.602777777778,0.656658047835,0.656658047835
11,1,32,0.243270189432,0.916162489196,0.715542521994,0.582737768004,0.363095238095,0.712365591398,341,1819,1060,759,97,244,0.603703703704,0.649140144999,0.649140144999
11,1,33,0.229968782518,0.903252710592,0.655786350148,0.594075699397,0.340523882897,0.716743878226,337,1823,1083,740,116,221,0.603703703704,0.624931024772,0.624931024772
11,1,34,0.214150943396,0.900909090909,0.675595238095,0.543311403509,0.325214899713,0.677838577291,336,1824,991,833,109,227,0.563888888889,0.609453320802,0.609453320802
11,1,35,0.238791423002,0.900352733686,0.684357541899,0.566592674806,0.354046242775,0.695504087193,358,1802,1021,781,113,245,0.586111111111,0.625475108353,0.625475108353
11,1,36,0.23818707811,0.912733748887,0.715942028986,0.564738292011,0.357452966715,0.69775357386,345,1815,1025,790,98,247,0.588888888889,0.640340160498,0.640340160498
11,1,37,0.227642276423,0.902210884354,0.660766961652,0.582646897309,0.338624338624,0.708041374708,339,1821,1061,760,115,224,0.594907407407,0.621706929481,0.621706929481
11,1,38,0.253138075314,0.904485049834,0.677871148459,0.603993344426,0.368621477532,0.724309943465,357,1803,1089,714,115,242,0.616203703704,0.640932246443,0.640932246443
11,1,39,0.247225025227,0.91873396065,0.720588235294,0.59010989011,0.368144252442,0.718634994982,340,1820,1074,746,95,245,0.610648148148,0.655349062702,0.655349062702
11,1,40,0.236329935125,0.91026827012,0.724431818182,0.544247787611,0.356394129979,0.681204569055,352,1808,984,824,97,255,0.573611111111,0.634339802896,0.634339802896
11,1,41,0.24201853759,0.904121110177,0.67335243553,0.593594699061,0.356060606061,0.716666666667,349,1811,1075,736,114,235,0.606481481481,0.633473567296,0.633473567296
11,1,42,0.231719876416,0.901597981497,0.657894736842,0.589658965897,0.34272658035,0.713002993016,342,1818,1072,746,117,225,0.600462962963,0.623776851369,0.623776851369
11,1,43,0.245436105477,0.913969335605,0.705539358601,0.590533847001,0.364183596689,0.717485790705,343,1817,1073,744,101,242,0.608796296296,0.648036602801,0.648036602801
11,1,44,0.232373386296,0.906331309627,0.684210526316,0.574807480748,0.346923647146,0.70346684618,342,1818,1045,773,108,234,0.59212962963,0.629509003532,0.629509003532
11,1,45,0.228150873965,0.910531220876,0.720930232558,0.537995594714,0.346610761705,0.676358601592,344,1816,977,839,96,248,0.56712962963,0.629462913636,0.629462913636
11,1,46,0.23197492163,0.900249376559,0.649122807018,0.595709570957,0.341801385681,0.716981132075,342,1818,1083,735,120,222,0.604166666667,0.622416188987,0.622416188987
11,1,47,0.239028944911,0.916437098255,0.737752161383,0.550468836183,0.361071932299,0.687801516196,347,1813,998,815,91,256,0.580555555556,0.644110498783,0.644110498783
11,1,48,0.244421906694,0.903747870528,0.680790960452,0.587486157254,0.359701492537,0.712080536913,354,1806,1061,745,113,241,0.602777777778,0.634138558853,0.634138558853
11,1,49,0.246015936255,0.910899653979,0.705714285714,0.581767955801,0.364844903988,0.710047201618,350,1810,1053,757,103,247,0.601851851852,0.643741120758,0.643741120758
11,1,50,0.231632653061,0.900847457627,0.65988372093,0.585352422907,0.342900302115,0.709612817089,344,1816,1063,753,117,227,0.597222222222,0.622618071919,0.622618071919
11,1,51,0.240740740741,0.904882154882,0.674351585014,0.592939878654,0.354814253222,0.716427857381,347,1813,1075,738,113,234,0.606018518519,0.633645731834,0.633645731834
11,1,52,0.215291750503,0.899656946827,0.646525679758,0.57353745216,0.323018867925,0.700500834725,331,1829,1049,780,117,214,0.584722222222,0.610031565959,0.610031565959
11,1,53,0.235820895522,0.904761904762,0.682997118156,0.57639271925,0.350591715976,0.704177897574,347,1813,1045,768,110,237,0.593518518519,0.629694918703,0.629694918703
11,1,54,0.227229146692,0.907788719785,0.697058823529,0.557142857143,0.34273318872,0.690500510725,340,1820,1014,806,103,237,0.579166666667,0.627100840336,0.627100840336
11,1,55,0.239195979899,0.901287553648,0.674220963173,0.581073602656,0.353115727003,0.706594885599,353,1807,1050,757,115,238,0.596296296296,0.627647282915,0.627647282915
11,1,56,0.255600814664,0.915959252971,0.717142857143,0.596132596685,0.376876876877,0.722222222222,350,1810,1079,731,99,251,0.615740740741,0.656637726914,0.656637726914
11,1,57,0.247033441208,0.905109489051,0.661849710983,0.615214994487,0.359780047133,0.732523793896,346,1814,1116,698,117,229,0.622685185185,0.638532352735,0.638532352735
11,1,58,0.248975409836,0.913006756757,0.702312138728,0.59592061742,0.367624810893,0.721147431621,346,1814,1081,733,103,243,0.612962962963,0.649116378074,0.649116378074
11,1,59,0.217564870259,0.905872193437,0.666666666667,0.572285870158,0.328066215199,0.701437646272,327,1833,1049,784,109,218,0.586574074074,0.619476268412,0.619476268412
11,1,60,0.237191650854,0.909584086799,0.714285714286,0.555801104972,0.356125356125,0.689986282579,350,1810,1006,804,100,250,0.581481481481,0.635043409629,0.635043409629
11,1,61,0.240279162512,0.915298184961,0.710914454277,0.581548599671,0.359165424739,0.711215580927,339,1821,1059,762,98,241,0.601851851852,0.646231526974,0.646231526974
11,1,62,0.239028944911,0.921946740129,0.75073313783,0.55195162177,0.362606232295,0.690508940853,341,1819,1004,815,85,256,0.583333333333,0.6513423798,0.6513423798
11,1,63,0.244532803181,0.919410745234,0.725663716814,0.582646897309,0.365799256506,0.713277310924,339,1821,1061,760,93,246,0.605092592593,0.654155307062,0.654155307062
11,1,64,0.240157480315,0.918706293706,0.724035608309,0.576522216127,0.360679970436,0.708459723627,337,1823,1051,772,93,244,0.599537037037,0.650278912218,0.650278912218
11,1,65,0.26218851571,0.918350848828,0.705539358601,0.62520638415,0.382306477093,0.743942370661,343,1817,1136,681,101,242,0.637962962963,0.665372871375,0.665372871375
11,1,66,0.249469214437,0.9039408867,0.667613636364,0.608960176991,0.363214837713,0.727693324521,352,1808,1101,707,117,235,0.618518518519,0.638286906677,0.638286906677
11,1,67,0.233791748527,0.912434325744,0.704142011834,0.571899012075,0.351032448378,0.70310391363,338,1822,1042,780,100,238,0.592592592593,0.638020511954,0.638020511954
11,1,68,0.244401168452,0.917034421889,0.727536231884,0.572451790634,0.365889212828,0.704884667571,345,1815,1039,776,94,251,0.597222222222,0.649994011259,0.649994011259
11,1,69,0.238454288407,0.921747042766,0.746312684366,0.556287753981,0.361428571429,0.693835616438,339,1821,1013,808,86,253,0.586111111111,0.651300219174,0.651300219174
11,1,70,0.257796257796,0.922370617696,0.727272727273,0.607476635514,0.380660015349,0.732515744117,341,1819,1105,714,93,248,0.626388888889,0.667374681393,0.667374681393
11,1,71,0.246981339188,0.903923138511,0.652173913043,0.622038567493,0.358280254777,0.736945169713,345,1815,1129,686,120,225,0.626851851852,0.637106240268,0.637106240268
11,1,72,0.245754245754,0.911993097498,0.706896551724,0.583333333333,0.36471460341,0.711544934366,348,1812,1057,755,102,246,0.603240740741,0.645114942529,0.645114942529
11,1,73,0.240272373541,0.907243816254,0.701704545455,0.568030973451,0.357971014493,0.698639455782,352,1808,1027,781,105,247,0.589814814815,0.634867759453,0.634867759453
11,1,74,0.245322245322,0.909849749583,0.686046511628,0.600220264317,0.361408882083,0.723291307233,344,1816,1090,726,108,236,0.613888888889,0.643133387973,0.643133387973
11,1,75,0.239463601533,0.904121863799,0.700280112045,0.559622850804,0.356887937188,0.691332648167,357,1803,1009,794,107,250,0.58287037037,0.629951481425,0.629951481425
11,1,76,0.233366434955,0.90459670425,0.68115942029,0.574655647383,0.347633136095,0.702830188679,345,1815,1043,772,110,235,0.591666666667,0.627907533836,0.627907533836
11,1,77,0.228804902962,0.908552074513,0.674698795181,0.586980306346,0.341723874905,0.713193752077,332,1828,1073,755,108,224,0.600462962963,0.630839550763,0.630839550763
11,1,78,0.231075697211,0.910034602076,0.690476190476,0.576754385965,0.346268656716,0.706040268456,336,1824,1052,772,104,232,0.594444444444,0.633615288221,0.633615288221
11,1,79,0.229896907216,0.899159663866,0.650145772595,0.588882773803,0.339680121858,0.711672763552,343,1817,1070,747,120,223,0.598611111111,0.619514273199,0.619514273199
11,1,80,0.244296577947,0.916967509025,0.736389684814,0.561016013252,0.366880799429,0.696128811237,349,1811,1016,795,92,257,0.589351851852,0.648702849033,0.648702849033
11,1,81,0.236363636364,0.911210762332,0.71387283237,0.560088202867,0.355140186916,0.693752133834,346,1814,1016,798,99,247,0.584722222222,0.636980517618,0.636980517618
11,1,82,0.234343434343,0.903418803419,0.672463768116,0.582369146006,0.347565543071,0.708207705193,345,1815,1057,758,113,232,0.596759259259,0.627416457061,0.627416457061
11,1,83,0.238834951456,0.910619469027,0.708933717579,0.567567567568,0.357298474946,0.699286442406,347,1813,1029,784,101,246,0.590277777778,0.638250642573,0.638250642573
11,1,84,0.225409836066,0.904560810811,0.660660660661,0.586206896552,0.336134453782,0.711391564264,333,1827,1071,756,113,220,0.597685185185,0.623433778606,0.623433778606
11,1,85,0.241982507289,0.913351016799,0.71757925072,0.569773855488,0.361918604651,0.701766304348,347,1813,1033,780,98,249,0.593518518519,0.643676553104,0.643676553104
11,1,86,0.252164502165,0.912621359223,0.683284457478,0.620120945574,0.36837944664,0.738461538462,341,1819,1128,691,108,233,0.630092592593,0.651702701526,0.651702701526
11,1,87,0.247108307045,0.909015715467,0.68115942029,0.605509641873,0.362654320988,0.726851851852,345,1815,1099,716,110,235,0.617592592593,0.643334531082,0.643334531082
11,1,88,0.242392444911,0.903065451533,0.663793103448,0.601545253863,0.355111452729,0.722093408413,348,1812,1090,722,117,231,0.611574074074,0.632669178656,0.632669178656
11,1,89,0.23317535545,0.910407239819,0.713043478261,0.554269972452,0.351428571429,0.68904109589,345,1815,1006,809,99,246,0.57962962963,0.633656725356,0.633656725356
11,1,90,0.227146814404,0.905292479109,0.706896551724,0.538079470199,0.343815513627,0.67497403946,348,1812,975,837,102,246,0.565277777778,0.622488010961,0.622488010961
11,1,91,0.242827868852,0.911317567568,0.69298245614,0.593509350935,0.359635811836,0.718854097268,342,1818,1079,739,105,237,0.609259259259,0.643245903538,0.643245903538
11,1,92,0.232490272374,0.917844522968,0.719879518072,0.568380743982,0.351470588235,0.702027027027,332,1828,1039,789,93,239,0.591666666667,0.644130131027,0.644130131027
11,1,93,0.229607250755,0.899742930591,0.660869565217,0.578512396694,0.340807174888,0.704225352113,345,1815,1050,765,117,228,0.591666666667,0.619690980956,0.619690980956
11,1,94,0.239626556017,0.913043478261,0.689552238806,0.598356164384,0.355658198614,0.722939424032,335,1825,1092,733,104,231,0.6125,0.643954201595,0.643954201595
11,1,95,0.244282744283,0.90734557596,0.679190751445,0.599228224917,0.359327217125,0.721779548473,346,1814,1087,727,111,235,0.612037037037,0.639209488181,0.639209488181
11,1,96,0.217054263566,0.886524822695,0.636363636364,0.553097345133,0.323699421965,0.681198910082,352,1808,1000,808,128,224,0.566666666667,0.594730490748,0.594730490748
11,1,97,0.246404602109,0.919427036705,0.740634005764,0.566464423607,0.369784172662,0.701023890785,347,1813,1027,786,90,257,0.594444444444,0.653549214685,0.653549214685
11,1,98,0.22972972973,0.909015025042,0.669696969697,0.595081967213,0.342105263158,0.71928665786,330,1830,1089,741,109,221,0.606481481481,0.632389468455,0.632389468455
11,1,99,0.24063670412,0.914835164835,0.734285714286,0.551933701657,0.362482369535,0.688490696072,350,1810,999,811,93,257,0.581481481481,0.643109707972,0.643109707972
13,1,0,0.233690360273,0.912621359223,0.70796460177,0.567819879187,0.351390922401,0.700067704807,339,1821,1034,787,99,240,0.589814814815,0.637892240479,0.637892240479
13,1,1,0.258271077908,0.903515944399,0.672222222222,0.613888888889,0.373168851195,0.73106185908,360,1800,1105,695,118,242,0.623611111111,0.643055555556,0.643055555556
13,1,2,0.237430167598,0.913443830571,0.730659025788,0.547763666483,0.35839775123,0.68484639282,349,1811,992,819,94,255,0.577314814815,0.639211346135,0.639211346135
13,1,3,0.242914979757,0.914675767918,0.705882352941,0.589010989011,0.361445783133,0.716577540107,340,1820,1072,748,100,240,0.607407407407,0.647446670976,0.647446670976
13,1,4,0.24131082423,0.914137033825,0.710526315789,0.579757975798,0.360266864344,0.709525412319,342,1818,1054,764,99,243,0.600462962963,0.645142145794,0.645142145794
13,1,5,0.244,0.913793103448,0.709302325581,0.583700440529,0.363095238095,0.712365591398,344,1816,1060,756,100,244,0.603703703704,0.646501383055,0.646501383055
13,1,6,0.22619047619,0.913194444444,0.69512195122,0.57423580786,0.341317365269,0.70509383378,328,1832,1052,780,100,228,0.592592592593,0.63467887954,0.63467887954
13,1,7,0.243523316062,0.912133891213,0.691176470588,0.598901098901,0.360153256705,0.723051409619,340,1820,1090,730,105,235,0.613425925926,0.645038784745,0.645038784745
13,1,8,0.234297108674,0.905790838375,0.683139534884,0.577092511013,0.348923533779,0.70501177262,344,1816,1048,768,109,235,0.593981481481,0.630116022948,0.630116022948
13,1,9,0.248136315229,0.904995904996,0.667621776504,0.610160132523,0.361801242236,0.72889182058,349,1811,1105,706,116,233,0.619444444444,0.638890954514,0.638890954514
13,1,10,0.245901639344,0.902027027027,0.674157303371,0.592017738359,0.36036036036,0.714859437751,356,1804,1068,736,116,240,0.605555555556,0.633087520865,0.633087520865
13,1,11,0.239239239239,0.912144702842,0.700879765396,0.582188015393,0.35671641791,0.710738255034,341,1819,1059,760,102,239,0.600925925926,0.641533890394,0.641533890394
13,1,12,0.234886025768,0.912250217202,0.701183431953,0.576289791438,0.351893095768,0.706357214934,338,1822,1050,772,101,237,0.595833333333,0.638736611695,0.638736611695
13,1,13,0.245483528162,0.910582444627,0.679411764706,0.60989010989,0.360655737705,0.730503455084,340,1820,1110,710,109,231,0.620833333333,0.644650937298,0.644650937298
13,1,14,0.23116089613,0.911714770798,0.68580060423,0.587206123565,0.345773038842,0.714333222481,331,1829,1074,755,104,227,0.602314814815,0.636503363897,0.636503363897
13,1,15,0.22619047619,0.90543071161,0.709770114943,0.533664459161,0.343055555556,0.671527777778,348,1812,967,845,101,247,0.562037037037,0.621717287052,0.621717287052
13,1,16,0.233626588465,0.910290237467,0.700879765396,0.568993952721,0.350439882698,0.700270635995,341,1819,1035,784,102,239,0.589814814815,0.634936859059,0.634936859059
13,1,17,0.240115718419,0.917186108638,0.728070175439,0.566556655666,0.361131254532,0.700442026522,342,1818,1030,788,93,249,0.59212962963,0.647313415552,0.647313415552
13,1,18,0.248520710059,0.920593368237,0.734693877551,0.580627407815,0.371407516581,0.712116098549,343,1817,1055,762,91,252,0.605092592593,0.657660642683,0.657660642683
13,1,19,0.223180076628,0.916666666667,0.71472392638,0.557797164667,0.340145985401,0.693559322034,326,1834,1023,811,93,233,0.581481481481,0.636260545524,0.636260545524
13,1,20,0.242926829268,0.913656387665,0.71757925072,0.571980143409,0.362973760933,0.703527815468,347,1813,1037,776,98,249,0.59537037037,0.644779697065,0.644779697065
13,1,21,0.246632124352,0.908786610879,0.685878962536,0.599007170436,0.362804878049,0.722074468085,347,1813,1086,727,109,238,0.612962962963,0.642443066486,0.642443066486
13,1,22,0.233333333333,0.909401709402,0.685459940653,0.583653318705,0.348153730219,0.710992315403,337,1823,1064,759,106,231,0.599537037037,0.634556629679,0.634556629679
13,1,23,0.239551478084,0.912637828668,0.695266272189,0.590559824369,0.35633055345,0.717094301899,338,1822,1076,746,103,235,0.606944444444,0.642913048279,0.642913048279
13,1,24,0.230331753555,0.911312217195,0.712609970674,0.553600879604,0.348137535817,0.68878248974,341,1819,1007,812,98,243,0.578703703704,0.633105425139,0.633105425139
13,1,25,0.249258160237,0.911227154047,0.71186440678,0.579734219269,0.369230769231,0.708629441624,354,1806,1047,759,102,252,0.601388888889,0.645799313024,0.645799313024
13,1,26,0.24513618677,0.913427561837,0.72,0.571270718232,0.365747460087,0.702923181509,350,1810,1034,776,98,252,0.59537037037,0.645635359116,0.645635359116
13,1,27,0.23156899811,0.915607985481,0.724852071006,0.553787047201,0.35100286533,0.690150478796,338,1822,1009,813,93,245,0.580555555556,0.639319559103,0.639319559103
13,1,28,0.233488372093,0.921658986175,0.747023809524,0.548245614035,0.355776045358,0.687521485046,336,1824,1000,824,85,251,0.579166666667,0.647634711779,0.647634711779
13,1,29,0.258711721225,0.920032976092,0.716374269006,0.613861386139,0.380139643134,0.736390630155,342,1818,1116,702,97,245,0.630092592593,0.665117827572,0.665117827572
13,1,30,0.246829268293,0.919823788546,0.735465116279,0.574889867841,0.369612856099,0.70755676042,344,1816,1044,772,91,253,0.600462962963,0.65517749206,0.65517749206
13,1,31,0.240882917466,0.913237924866,0.721264367816,0.563465783664,0.361151079137,0.696928327645,348,1812,1021,791,97,251,0.588888888889,0.64236507574,0.64236507574
13,1,32,0.238911290323,0.911815068493,0.697058823529,0.585164835165,0.355855855856,0.712851405622,340,1820,1065,755,103,237,0.602777777778,0.641111829347,0.641111829347
13,1,33,0.244174265451,0.913043478261,0.702623906706,0.589433131535,0.362406015038,0.716387959866,343,1817,1071,746,102,241,0.607407407407,0.646028519121,0.646028519121
13,1,34,0.237574552684,0.909878682842,0.696793002915,0.577875619152,0.354336545589,0.706832716257,343,1817,1050,767,104,239,0.596759259259,0.637334311034,0.637334311034
13,1,35,0.236920039487,0.909328683522,0.697674418605,0.574339207048,0.353721444363,0.704016199798,344,1816,1043,773,104,240,0.593981481481,0.636006812827,0.636006812827
13,1,36,0.233429394813,0.909740840036,0.706395348837,0.560572687225,0.350902527076,0.693696763203,344,1816,1018,798,101,243,0.583796296296,0.633484018031,0.633484018031
13,1,37,0.219361483007,0.895710681245,0.632047477745,0.584201865058,0.325688073394,0.707171314741,337,1823,1065,758,124,213,0.591666666667,0.608124671401,0.608124671401
13,1,38,0.252040816327,0.916101694915,0.71387283237,0.59592061742,0.372549019608,0.722110888444,346,1814,1081,733,99,247,0.614814814815,0.654896724895,0.654896724895
13,1,39,0.242698892246,0.911739502999,0.700581395349,0.5859030837,0.360508601346,0.713375796178,344,1816,1064,752,103,241,0.604166666667,0.643242239525,0.643242239525
13,1,40,0.235233160622,0.909623430962,0.677611940299,0.595616438356,0.349230769231,0.719867549669,335,1825,1087,738,108,227,0.608333333333,0.636614189327,0.636614189327
13,1,41,0.227408142999,0.908933217693,0.685628742515,0.573932092004,0.34153616704,0.703591809332,334,1826,1048,778,105,229,0.591203703704,0.62978041726,0.62978041726
13,1,42,0.243301178992,0.903830480848,0.657971014493,0.611019283747,0.35524256651,0.729125575279,345,1815,1109,706,118,227,0.618518518519,0.63449514912,0.63449514912
13,1,43,0.234555984556,0.91103202847,0.708454810496,0.563566318107,0.352429296592,0.696361781707,343,1817,1024,793,100,243,0.586574074074,0.636010564301,0.636010564301
13,1,44,0.240374609781,0.914095079233,0.691616766467,0.60021905805,0.356756756757,0.724628099174,334,1826,1096,730,103,231,0.614351851852,0.645917912259,0.645917912259
13,1,45,0.241164241164,0.90734557596,0.67638483965,0.598238855256,0.355555555556,0.721061359867,343,1817,1087,730,111,232,0.610648148148,0.637311847453,0.637311847453
13,1,46,0.247855100095,0.922592259226,0.751445086705,0.565049614112,0.372759856631,0.700854700855,346,1814,1025,789,86,260,0.594907407407,0.658247350409,0.658247350409
13,1,47,0.241279069767,0.913120567376,0.71757925072,0.568119139548,0.361131254532,0.700442026522,347,1813,1030,783,98,249,0.59212962963,0.642849195134,0.642849195134
13,1,48,0.239766081871,0.91975308642,0.729970326409,0.57213384531,0.360968451944,0.705444707474,337,1823,1043,780,91,246,0.596759259259,0.65105208586,0.65105208586
13,1,49,0.224371373308,0.910301953819,0.696696696697,0.561029009305,0.339429407462,0.6942092787,333,1827,1025,802,101,232,0.581944444444,0.628862853001,0.628862853001
13,1,50,0.232783705141,0.908768821966,0.69970845481,0.564667033572,0.349344978166,0.696537678208,343,1817,1026,791,103,240,0.586111111111,0.632187744191,0.632187744191
13,1,51,0.263541666667,0.92,0.724928366762,0.609607951408,0.386554621849,0.733311192295,349,1811,1104,707,96,253,0.628240740741,0.667268159085,0.667268159085
13,1,52,0.251491053678,0.921143847487,0.735465116279,0.585352422907,0.374814814815,0.715824915825,344,1816,1063,753,91,253,0.609259259259,0.660408769593,0.660408769593
13,1,53,0.24375,0.909166666667,0.68221574344,0.600440286186,0.359171143515,0.723235001657,343,1817,1091,726,109,234,0.613425925926,0.641328014813,0.641328014813
13,1,54,0.247578040904,0.910641754671,0.676470588235,0.615934065934,0.362490149724,0.734841035726,340,1820,1121,699,110,230,0.625462962963,0.646202327085,0.646202327085
13,1,55,0.251546391753,0.91512605042,0.707246376812,0.6,0.371102661597,0.724792013311,345,1815,1089,726,101,244,0.61712962963,0.653623188406,0.653623188406
13,1,56,0.253374870197,0.91395154553,0.703170028818,0.603419746277,0.372519083969,0.726910299003,347,1813,1094,719,103,244,0.619444444444,0.653294887548,0.653294887548
13,1,57,0.244529019981,0.920649233544,0.744927536232,0.562534435262,0.368194842407,0.698358413133,345,1815,1021,794,88,257,0.591666666667,0.653730985747,0.653730985747
13,1,58,0.241170534813,0.914456800684,0.705014749263,0.587040087864,0.359398496241,0.715050167224,339,1821,1069,752,100,239,0.605555555556,0.646027418563,0.646027418563
13,1,59,0.218808193669,0.914364640884,0.716463414634,0.542030567686,0.335235378031,0.680603152844,328,1832,993,839,93,235,0.568518518519,0.62924699116,0.62924699116
13,1,60,0.236790606654,0.912126537786,0.707602339181,0.57095709571,0.354838709677,0.702300405954,342,1818,1038,780,100,242,0.592592592593,0.639279717445,0.639279717445
13,1,61,0.24613800206,0.907485281749,0.684813753582,0.595803423523,0.362121212121,0.719333333333,349,1811,1079,732,110,239,0.610185185185,0.640308588552,0.640308588552
13,1,62,0.238679245283,0.924545454545,0.752976190476,0.557565789474,0.362464183381,0.695622435021,336,1824,1017,807,83,253,0.587962962963,0.655270989975,0.655270989975
13,1,63,0.239626556017,0.916387959866,0.697885196375,0.599234554401,0.356756756757,0.724628099174,331,1829,1096,733,100,231,0.614351851852,0.648559875388,0.648559875388
13,1,64,0.241071428571,0.908854166667,0.698275862069,0.577814569536,0.358407079646,0.706477732794,348,1812,1047,765,105,243,0.597222222222,0.638045215803,0.638045215803
13,1,65,0.242063492063,0.914930555556,0.713450292398,0.579757975798,0.361481481481,0.709764309764,342,1818,1054,764,98,244,0.600925925926,0.646604134098,0.646604134098
13,1,66,0.238821138211,0.913265306122,0.697329376855,0.589138782227,0.355791067373,0.716238746249,337,1823,1074,749,102,235,0.606018518519,0.643234079541,0.643234079541
13,1,67,0.247534516765,0.915357766143,0.721264367816,0.578918322296,0.368575624082,0.709263015551,348,1812,1049,763,97,251,0.601851851852,0.650091345056,0.650091345056
13,1,68,0.234021632252,0.902887139108,0.681948424069,0.569850911099,0.348462664714,0.698713608666,349,1811,1032,779,111,238,0.587962962963,0.625899667584,0.625899667584
13,1,69,0.232085561497,0.900408163265,0.6401179941,0.605711147721,0.340659340659,0.724228496389,339,1821,1103,718,122,217,0.611111111111,0.622914570911,0.622914570911
13,1,70,0.236258437801,0.908281389136,0.704022988506,0.562913907285,0.353790613718,0.695059625213,348,1812,1020,792,103,245,0.585648148148,0.633468447895,0.633468447895
13,1,71,0.245302713987,0.905990016639,0.675287356322,0.600993377483,0.359877488515,0.722627737226,348,1812,1089,723,113,235,0.612962962963,0.638140366903,0.638140366903
13,1,72,0.247484909457,0.909090909091,0.698863636364,0.586283185841,0.365527488856,0.712844653665,352,1808,1060,748,106,246,0.60462962963,0.642573411102,0.642573411102
13,1,73,0.245098039216,0.914035087719,0.718390804598,0.575055187638,0.365497076023,0.705962059621,348,1812,1042,770,98,250,0.598148148148,0.646722996118,0.646722996118
13,1,74,0.237647058824,0.900763358779,0.60843373494,0.645514223195,0.34179357022,0.752071383047,332,1828,1180,648,130,202,0.639814814815,0.626973979067,0.626973979067
13,1,75,0.245283018868,0.908789386401,0.68023255814,0.603524229075,0.360554699538,0.725347452019,344,1816,1096,720,110,234,0.615740740741,0.641878393607,0.641878393607
13,1,76,0.231141199226,0.907637655417,0.696793002915,0.562465602642,0.347131445171,0.694529391777,343,1817,1022,795,104,239,0.583796296296,0.629629302779,0.629629302779
13,1,77,0.233170731707,0.911894273128,0.705014749263,0.568369028007,0.350439882698,0.700270635995,339,1821,1035,786,100,239,0.589814814815,0.636691888635,0.636691888635
13,1,78,0.237804878049,0.904761904762,0.676300578035,0.586549062845,0.351879699248,0.711705685619,346,1814,1064,750,112,234,0.600925925926,0.63142482044,0.63142482044
13,1,79,0.245098039216,0.902576489533,0.650289017341,0.617971334068,0.356012658228,0.733638743455,346,1814,1121,693,121,225,0.623148148148,0.634130175705,0.634130175705
13,1,80,0.241245136187,0.912544169611,0.71469740634,0.569773855488,0.360727272727,0.701528013582,347,1813,1033,780,99,248,0.593055555556,0.642235630914,0.642235630914
13,1,81,0.22517207473,0.90813648294,0.685628742515,0.568455640745,0.339008142117,0.699225328393,334,1826,1038,788,105,229,0.586574074074,0.62704219163,0.62704219163
13,1,82,0.251655629139,0.922937443336,0.757834757835,0.562741846324,0.377840909091,0.699175824176,351,1809,1018,791,85,266,0.594444444444,0.660288302079,0.660288302079
13,1,83,0.227911646586,0.906357388316,0.675595238095,0.578399122807,0.340840840841,0.706157965194,336,1824,1055,769,109,227,0.593518518519,0.626997180451,0.626997180451
13,1,84,0.235591506572,0.907771135781,0.683284457478,0.584387025838,0.35037593985,0.711036789298,341,1819,1063,756,108,233,0.6,0.633835741658,0.633835741658
13,1,85,0.227741330834,0.906678865508,0.704347826087,0.546005509642,0.344192634561,0.681568088033,345,1815,991,824,102,243,0.571296296296,0.625176667864,0.625176667864
13,1,86,0.23661971831,0.91598173516,0.732558139535,0.55231277533,0.357700496806,0.689110271384,344,1816,1003,813,92,252,0.581018518519,0.642435457433,0.642435457433
13,1,87,0.244399185336,0.915110356537,0.705882352941,0.592307692308,0.36308623298,0.719146097398,340,1820,1078,742,100,240,0.610185185185,0.649095022624,0.649095022624
13,1,88,0.248962655602,0.918060200669,0.710059171598,0.602634467618,0.36866359447,0.727634194831,338,1822,1098,724,98,240,0.619444444444,0.656346819608,0.656346819608
13,1,89,0.260778128286,0.918114143921,0.71469740634,0.612244897959,0.382126348228,0.734612839179,347,1813,1110,703,99,248,0.628703703704,0.66347115215,0.66347115215
13,1,90,0.238636363636,0.911073825503,0.685459940653,0.595721338453,0.354022988506,0.72039800995,337,1823,1086,737,106,231,0.609722222222,0.640590639553,0.640590639553
13,1,91,0.243083003953,0.914634146341,0.71511627907,0.578193832599,0.362831858407,0.708502024291,344,1816,1050,766,98,246,0.6,0.646655055834,0.646655055834
13,1,92,0.2375,0.926923076923,0.777777777778,0.530253025303,0.363885088919,0.674597620714,342,1818,964,854,76,266,0.569444444444,0.65401540154,0.65401540154
13,1,93,0.234664070107,0.909973521624,0.702623906706,0.567418822234,0.351824817518,0.698983050847,343,1817,1031,786,102,241,0.588888888889,0.63502136447,0.63502136447
13,1,94,0.253303964758,0.907348242812,0.664739884393,0.626240352811,0.3668261563,0.741030658839,346,1814,1136,678,116,230,0.632407407407,0.645490118602,0.645490118602
13,1,95,0.2435500516,0.905961376994,0.67816091954,0.595474613687,0.358390280942,0.718614718615,348,1812,1079,733,112,236,0.608796296296,0.636817766613,0.636817766613
13,1,96,0.221084953941,0.897717666948,0.640949554896,0.582556226001,0.328767123288,0.706586826347,337,1823,1062,761,121,216,0.591666666667,0.611752890449,0.611752890449
13,1,97,0.233644859813,0.908939014202,0.673652694611,0.595837897043,0.346954510409,0.719814753556,334,1826,1088,738,109,225,0.60787037037,0.634745295827,0.634745295827
13,1,98,0.234509056244,0.907290729073,0.704871060172,0.556598564329,0.351931330472,0.689938398357,349,1811,1008,803,103,246,0.580555555556,0.630734812251,0.630734812251
13,1,99,0.242362525458,0.907470288625,0.685878962536,0.589630446773,0.358164033108,0.714811099967,347,1813,1069,744,109,238,0.605092592593,0.637754704655,0.637754704655
15,1,0,0.233663366337,0.90347826087,0.680115273775,0.573083287369,0.347826086957,0.701316233547,347,1813,1039,774,111,236,0.590277777778,0.626599280572,0.626599280572
15,1,1,0.244357212954,0.914110429448,0.71757925072,0.57528957529,0.364568081991,0.706161137441,347,1813,1043,770,98,249,0.598148148148,0.646434413005,0.646434413005
15,1,2,0.23400191022,0.913746630728,0.718475073314,0.559098405717,0.353025936599,0.693724420191,341,1819,1017,802,96,245,0.584259259259,0.638786739516,0.638786739516
15,1,3,0.253551912568,0.911646586345,0.678362573099,0.624312431243,0.369132856006,0.741103493307,342,1818,1135,683,110,232,0.63287037037,0.651337502171,0.651337502171
15,1,4,0.22619047619,0.911048689139,0.722222222222,0.535203520352,0.344490934449,0.67428967429,342,1818,973,845,95,247,0.564814814815,0.628712871287,0.628712871287
15,1,5,0.232960325534,0.909940526763,0.683582089552,0.586849315068,0.347496206373,0.713524317122,335,1825,1071,754,106,229,0.601851851852,0.63521570231,0.63521570231
15,1,6,0.239005736138,0.917414721724,0.730994152047,0.562156215622,0.36023054755,0.697135061392,342,1818,1022,796,92,250,0.588888888889,0.646575183834,0.646575183834
15,1,7,0.252535496957,0.916524701874,0.71757925072,0.593491450634,0.37359339835,0.720455306327,347,1813,1076,737,98,249,0.613425925926,0.655535350677,0.655535350677
15,1,8,0.249038461538,0.910714285714,0.721448467967,0.566352026652,0.370264474625,0.698390961999,359,1801,1020,781,100,259,0.59212962963,0.643900247309,0.643900247309
15,1,9,0.25,0.917253521127,0.731428571429,0.575690607735,0.372634643377,0.707399864223,350,1810,1042,768,94,256,0.600925925926,0.653559589582,0.653559589582
15,1,10,0.247148288973,0.926895306859,0.762463343109,0.564595931831,0.373295046662,0.70174239836,341,1819,1027,792,81,260,0.595833333333,0.66352963747,0.66352963747
15,1,11,0.240196078431,0.916666666667,0.720588235294,0.574175824176,0.360294117647,0.706081081081,340,1820,1045,775,95,245,0.597222222222,0.647382029735,0.647382029735
15,1,12,0.237438423645,0.908296943231,0.696531791908,0.573318632856,0.354151359295,0.702940182494,346,1814,1040,774,105,241,0.593055555556,0.634925212382,0.634925212382
15,1,13,0.25398512221,0.915504511895,0.698830409357,0.613861386139,0.372564302416,0.7349357919,342,1818,1116,702,103,239,0.627314814815,0.656345897748,0.656345897748
15,1,14,0.258938244854,0.911075181892,0.684813753582,0.622308117062,0.375786163522,0.739501312336,349,1811,1127,684,110,239,0.632407407407,0.653560935322,0.653560935322
15,1,15,0.23782234957,0.915543575921,0.725947521866,0.560814529444,0.358273381295,0.695563139932,343,1817,1019,798,94,249,0.587037037037,0.643381025655,0.643381025655
15,1,16,0.232692307692,0.917857142857,0.724550898204,0.562979189485,0.352256186317,0.69789545146,334,1826,1028,798,92,242,0.587962962963,0.643765043844,0.643765043844
15,1,17,0.237113402062,0.908403361345,0.678466076696,0.593629873696,0.35141329259,0.718033875789,339,1821,1081,740,109,230,0.606944444444,0.636047975196,0.636047975196
15,1,18,0.247770069376,0.911381407472,0.710227272727,0.580199115044,0.367376928729,0.709023318689,352,1808,1049,759,102,250,0.601388888889,0.645213193886,0.645213193886
15,1,19,0.245098039216,0.912280701754,0.714285714286,0.574585635359,0.36496350365,0.705084745763,350,1810,1040,770,100,250,0.597222222222,0.644435674822,0.644435674822
15,1,20,0.248015873016,0.920138888889,0.730994152047,0.583058305831,0.37037037037,0.713804713805,342,1818,1060,758,92,250,0.606481481481,0.657026228939,0.657026228939
15,1,21,0.239508700102,0.9078613694,0.68221574344,0.591084204733,0.354545454545,0.716,343,1817,1074,743,109,234,0.605555555556,0.636649974087,0.636649974087
15,1,22,0.23585810163,0.910474485228,0.71098265896,0.560639470783,0.354211663067,0.693961105425,346,1814,1017,797,100,246,0.584722222222,0.635811064871,0.635811064871
15,1,23,0.237859266601,0.912250217202,0.703812316716,0.577240241891,0.355555555556,0.707070707071,341,1819,1050,769,101,240,0.597222222222,0.640526279303,0.640526279303
15,1,24,0.241855873643,0.915431560593,0.716374269006,0.577557755776,0.361623616236,0.70826306914,342,1818,1050,768,97,245,0.599537037037,0.646966012391,0.646966012391
15,1,25,0.248693834901,0.904405652535,0.674220963173,0.602102933038,0.363358778626,0.72292358804,353,1807,1088,719,115,238,0.613888888889,0.638161948105,0.638161948105
15,1,26,0.231768231768,0.912855910267,0.696696696697,0.579091406678,0.347826086957,0.7086403215,333,1827,1058,769,101,232,0.597222222222,0.637894051687,0.637894051687
15,1,27,0.248704663212,0.923012552301,0.722891566265,0.603391684902,0.370084811103,0.729738670195,332,1828,1103,725,92,240,0.621759259259,0.663141625583,0.663141625583
15,1,28,0.247301275761,0.918492550394,0.730434782609,0.57741046832,0.369501466276,0.709066305819,345,1815,1048,767,93,252,0.601851851852,0.653922625464,0.653922625464
15,1,29,0.252346193952,0.916736053289,0.707602339181,0.605610561056,0.372021521906,0.729380589599,342,1818,1101,717,100,242,0.621759259259,0.656606450119,0.656606450119
15,1,30,0.236976506639,0.90516511431,0.674418604651,0.588656387665,0.350718065004,0.713380046713,344,1816,1069,747,112,232,0.602314814815,0.631537496158,0.631537496158
15,1,31,0.245345016429,0.911788291901,0.670658682635,0.622672508215,0.35926222935,0.739993491702,334,1826,1137,689,110,224,0.630092592593,0.646665595425,0.646665595425
15,1,32,0.239341085271,0.921985815603,0.737313432836,0.569863013699,0.361375274323,0.704368438876,335,1825,1040,785,88,247,0.595833333333,0.653588223267,0.653588223267
15,1,33,0.260289210234,0.911181601903,0.676300578035,0.633406835722,0.375903614458,0.747317073171,346,1814,1149,665,112,234,0.640277777778,0.654853706878,0.654853706878
15,1,34,0.23330106486,0.912156166815,0.708823529412,0.564835164835,0.351056081573,0.697658635901,340,1820,1028,792,99,241,0.5875,0.636829347123,0.636829347123
15,1,35,0.239151398264,0.909171861086,0.708571428571,0.56408839779,0.357606344629,0.696215479032,350,1810,1021,789,102,248,0.5875,0.636329913181,0.636329913181
15,1,36,0.235567970205,0.917127071823,0.737609329446,0.548156301596,0.357092448836,0.68618670341,343,1817,996,821,90,253,0.578240740741,0.642882815521,0.642882815521
15,1,37,0.234234234234,0.900947459087,0.670487106017,0.577581446715,0.347181008902,0.703903095559,349,1811,1046,765,115,234,0.592592592593,0.624034276366,0.624034276366
15,1,38,0.231547017189,0.908625106746,0.681547619048,0.583333333333,0.345660377358,0.710517529215,336,1824,1064,760,107,229,0.598611111111,0.63244047619,0.63244047619
15,1,39,0.246794871795,0.90931372549,0.675438596491,0.612211221122,0.361502347418,0.731755424063,342,1818,1113,705,111,231,0.622222222222,0.643824908807,0.643824908807
15,1,40,0.250257466529,0.915054667788,0.706395348837,0.599118942731,0.369581749049,0.724126455907,344,1816,1088,728,101,243,0.616203703704,0.652757145784,0.652757145784
15,1,41,0.23779854621,0.90142021721,0.659942363112,0.595146166575,0.349618320611,0.716943521595,347,1813,1079,734,118,229,0.605555555556,0.627544264844,0.627544264844
15,1,42,0.228292682927,0.909251101322,0.694362017804,0.566099835436,0.343612334802,0.697768762677,337,1823,1032,791,103,234,0.586111111111,0.63023092662,0.63023092662
15,1,43,0.237623762376,0.918260869565,0.718562874251,0.578313253012,0.357142857143,0.709677419355,334,1826,1056,770,94,240,0.6,0.648438063632,0.648438063632
15,1,44,0.237132352941,0.924440298507,0.761061946903,0.544206479956,0.361597757533,0.685101970273,339,1821,991,830,81,258,0.578240740741,0.652634213429,0.652634213429
15,1,45,0.241666666667,0.909166666667,0.680351906158,0.599780098955,0.356648731745,0.72275587943,341,1819,1091,728,109,232,0.6125,0.640066002557,0.640066002557
15,1,46,0.252699784017,0.902755267423,0.661016949153,0.616832779623,0.365625,0.732894736842,354,1806,1114,692,120,234,0.624074074074,0.638924864388,0.638924864388
15,1,47,0.237791932059,0.911330049261,0.674698795181,0.607221006565,0.351648351648,0.728824688116,332,1828,1110,718,108,224,0.617592592593,0.640959900873,0.640959900873
15,1,48,0.25025025025,0.915590008613,0.718390804598,0.586644591611,0.371195248701,0.715102589976,348,1812,1063,749,98,250,0.60787037037,0.652517698105,0.652517698105
15,1,49,0.227754237288,0.905427631579,0.651515151515,0.601639344262,0.337519623234,0.722915298752,330,1830,1101,729,115,215,0.609259259259,0.626577247889,0.626577247889
15,1,50,0.251004016064,0.925257731959,0.741839762611,0.590784421284,0.375093773443,0.721124874456,337,1823,1077,746,87,250,0.614351851852,0.666312091947,0.666312091947
15,1,51,0.248979591837,0.91186440678,0.701149425287,0.593818984547,0.367469879518,0.719251336898,348,1812,1076,736,104,244,0.611111111111,0.647484204917,0.647484204917
15,1,52,0.245483528162,0.917965545529,0.697885196375,0.611809732094,0.36320754717,0.734251968504,331,1829,1119,710,100,231,0.625,0.654847464234,0.654847464234
15,1,53,0.24236453202,0.914410480349,0.71511627907,0.57654185022,0.362030905077,0.707193515704,344,1816,1047,769,98,246,0.598611111111,0.645829064645,0.645829064645
15,1,54,0.249322493225,0.930674264008,0.790830945559,0.541137493098,0.379120879121,0.684357541899,349,1811,980,831,73,276,0.581481481481,0.665984219328,0.665984219328
15,1,55,0.252261306533,0.915021459227,0.717142857143,0.588950276243,0.373234200743,0.716638655462,350,1810,1066,744,99,251,0.609722222222,0.653046566693,0.653046566693
15,1,56,0.256325632563,0.906474820144,0.665714285714,0.626519337017,0.3701350278,0.740934335185,350,1810,1134,676,117,233,0.63287037037,0.646116811365,0.646116811365
15,1,57,0.239771646051,0.919747520289,0.739002932551,0.560747663551,0.362068965517,0.696721311475,341,1819,1020,799,89,252,0.588888888889,0.649875298051,0.649875298051
15,1,58,0.242424242424,0.916446789798,0.723032069971,0.573472757292,0.363103953148,0.70548408937,343,1817,1042,775,95,248,0.597222222222,0.648252413632,0.648252413632
15,1,59,0.23768115942,0.910222222222,0.708933717579,0.564809707667,0.356005788712,0.697072838666,347,1813,1024,789,101,246,0.587962962963,0.636871712623,0.636871712623
15,1,60,0.247629083246,0.905862923204,0.67335243553,0.6057426836,0.362095531587,0.726009265387,349,1811,1097,714,114,235,0.616666666667,0.639547559565,0.639547559565
15,1,61,0.241241241241,0.915590008613,0.710914454277,0.583745194948,0.36023916293,0.712944332663,339,1821,1063,758,98,241,0.603703703704,0.647329824613,0.647329824613
15,1,62,0.242394504416,0.916739702016,0.722222222222,0.575357535754,0.362968405584,0.706995606624,342,1818,1046,772,95,247,0.598611111111,0.648789878988,0.648789878988
15,1,63,0.248,0.918965517241,0.72514619883,0.586358635864,0.369597615499,0.715916722633,342,1818,1066,752,94,248,0.608333333333,0.655752417347,0.655752417347
15,1,64,0.234674329502,0.914874551971,0.720588235294,0.560989010989,0.354046242775,0.695504087193,340,1820,1021,799,95,245,0.586111111111,0.640788623142,0.640788623142
15,1,65,0.232514177694,0.911978221416,0.717201166181,0.553109521189,0.351177730193,0.688591983556,343,1817,1005,812,97,246,0.579166666667,0.635155343685,0.635155343685
15,1,66,0.241446725318,0.911169744943,0.709770114943,0.57174392936,0.360320933625,0.702611054595,348,1812,1036,776,101,247,0.593981481481,0.640757022151,0.640757022151
15,1,67,0.228678537957,0.907593778591,0.707246376812,0.546556473829,0.345609065156,0.682255845942,345,1815,992,823,101,244,0.572222222222,0.62690142532,0.62690142532
15,1,68,0.241791044776,0.909956709957,0.700288184438,0.579702151131,0.359467455621,0.708221024259,347,1813,1051,762,104,243,0.599074074074,0.639995167784,0.639995167784
15,1,69,0.238791423002,0.91975308642,0.729166666667,0.571820175439,0.359765051395,0.705206220419,336,1824,1043,781,91,245,0.596296296296,0.650493421053,0.650493421053
15,1,70,0.260469867211,0.919559695174,0.728571428571,0.6,0.38374717833,0.726178535607,350,1810,1086,724,95,255,0.620833333333,0.664285714286,0.664285714286
15,1,71,0.262329485834,0.921292460646,0.724637681159,0.612672176309,0.385208012327,0.735936465917,345,1815,1112,703,95,250,0.630555555556,0.668654928734,0.668654928734
15,1,72,0.243705941591,0.908311910883,0.69340974212,0.58531198233,0.360655737705,0.711887172599,349,1811,1060,751,107,242,0.602777777778,0.639360862225,0.639360862225
15,1,73,0.238821138211,0.913265306122,0.697329376855,0.589138782227,0.355791067373,0.716238746249,337,1823,1074,749,102,235,0.606018518519,0.643234079541,0.643234079541
15,1,74,0.221238938053,0.905511811024,0.675675675676,0.566502463054,0.333333333333,0.69696969697,333,1827,1035,792,108,225,0.583333333333,0.621089069365,0.621089069365
15,1,75,0.25051975052,0.91652754591,0.706744868035,0.603628367235,0.369915579432,0.727875372887,341,1819,1098,721,100,241,0.619907407407,0.655186617635,0.655186617635
15,1,76,0.244131455399,0.923287671233,0.755813953488,0.556718061674,0.369056068133,0.694606664377,344,1816,1011,805,84,260,0.588425925926,0.656266007581,0.656266007581
15,1,77,0.247311827957,0.905691056911,0.664739884393,0.614112458655,0.360501567398,0.731931668857,346,1814,1114,700,116,230,0.622222222222,0.639426171524,0.639426171524
15,1,78,0.247582205029,0.915630550622,0.729344729345,0.569928137092,0.369675090253,0.702555366269,351,1809,1031,778,95,256,0.595833333333,0.649636433219,0.649636433219
15,1,79,0.239593908629,0.908936170213,0.68804664723,0.587782058338,0.355421686747,0.713903743316,343,1817,1068,749,107,236,0.603703703704,0.637914352784,0.637914352784
15,1,80,0.250780437045,0.917431192661,0.708823529412,0.604395604396,0.37048424289,0.728718118582,340,1820,1100,720,99,241,0.620833333333,0.656609566904,0.656609566904
15,1,81,0.249469214437,0.908866995074,0.679190751445,0.610253583241,0.364906832298,0.730211081794,346,1814,1107,707,111,235,0.621296296296,0.644722167343,0.644722167343
15,1,82,0.251681075889,0.922252010724,0.750716332378,0.569850911099,0.376978417266,0.704436860068,349,1811,1032,779,87,262,0.599074074074,0.660283621739,0.660283621739
15,1,83,0.24593495935,0.913265306122,0.703488372093,0.59140969163,0.364457831325,0.717914438503,344,1816,1074,742,102,242,0.609259259259,0.647449031861,0.647449031861
15,1,84,0.231357552581,0.916517055655,0.722388059701,0.559452054795,0.350470673425,0.694794147669,335,1825,1021,804,93,242,0.584722222222,0.640920057248,0.640920057248
15,1,85,0.249723756906,0.913944223108,0.676646706587,0.628148959474,0.364810330912,0.744563453424,334,1826,1147,679,108,226,0.635648148148,0.652397833031,0.652397833031
15,1,86,0.254444444444,0.915873015873,0.683582089552,0.632328767123,0.370850202429,0.748136142626,335,1825,1154,671,106,229,0.640277777778,0.657955428338,0.657955428338
15,1,87,0.238691049086,0.921498661909,0.738095238095,0.566337719298,0.360727272727,0.701528013582,336,1824,1033,791,88,248,0.593055555556,0.652216478697,0.652216478697
15,1,88,0.239151398264,0.916295636687,0.72514619883,0.56600660066,0.359680928209,0.699761985719,342,1818,1029,789,94,248,0.591203703704,0.645576399745,0.645576399745
15,1,89,0.245125348189,0.917820867959,0.747875354108,0.550083010515,0.369230769231,0.687889273356,353,1807,994,813,89,264,0.582407407407,0.648979182311,0.648979182311
15,1,90,0.242105263158,0.909917355372,0.678466076696,0.604612850082,0.356865787432,0.726492906631,339,1821,1101,720,109,230,0.616203703704,0.641539463389,0.641539463389
15,1,91,0.232558139535,0.913120567376,0.710059171598,0.56531284303,0.350364963504,0.698305084746,338,1822,1030,792,98,240,0.587962962963,0.637686007314,0.637686007314
15,1,92,0.242669362993,0.910333048676,0.695652173913,0.587327823691,0.359820089955,0.713998660415,345,1815,1066,749,105,240,0.60462962963,0.641489998802,0.641489998802
15,1,93,0.224637681159,0.914772727273,0.733727810651,0.530186608123,0.343966712899,0.671299513551,338,1822,966,856,90,248,0.562037037037,0.631957209387,0.631957209387
15,1,94,0.259259259259,0.92420327304,0.746397694524,0.591836734694,0.384843982169,0.721587088097,347,1813,1073,740,88,259,0.616666666667,0.669117214609,0.669117214609
15,1,95,0.254149377593,0.916387959866,0.710144927536,0.603856749311,0.374331550802,0.727997343075,345,1815,1096,719,100,245,0.620833333333,0.657000838424,0.657000838424
15,1,96,0.237903225806,0.906678082192,0.684057971014,0.58347107438,0.353029169783,0.710023466309,345,1815,1059,756,109,236,0.599537037037,0.633764522697,0.633764522697
15,1,97,0.226804123711,0.909423604758,0.709677419355,0.546454095657,0.34375,0.682692307692,341,1819,994,825,99,242,0.572222222222,0.628065757506,0.628065757506
15,1,98,0.23987854251,0.914675767918,0.703264094955,0.588041689523,0.357735849057,0.715859766277,337,1823,1072,751,100,237,0.606018518519,0.645652892239,0.645652892239
15,1,99,0.248046875,0.917253521127,0.729885057471,0.575055187638,0.370262390671,0.706919945726,348,1812,1042,770,94,254,0.6,0.652470122555,0.652470122555
17,1,0,0.250832408435,0.911834789515,0.670623145401,0.629731212287,0.365105008078,0.744970798183,337,1823,1148,675,111,226,0.636111111111,0.650177178844,0.650177178844
17,1,1,0.255991285403,0.913043478261,0.685131195335,0.624105668685,0.372720063442,0.741418764302,343,1817,1134,683,108,235,0.633796296296,0.65461843201,0.65461843201
17,1,2,0.241103202847,0.927606177606,0.78323699422,0.529768467475,0.368707482993,0.674385964912,346,1814,961,853,75,271,0.57037037037,0.656502730847,0.656502730847
17,1,3,0.255406797116,0.913372582002,0.706552706553,0.600331674959,0.375189107413,0.724482988659,351,1809,1086,723,103,248,0.617592592593,0.653442190756,0.653442190756
17,1,4,0.243628950051,0.911789652248,0.696793002915,0.591634562466,0.361027190332,0.717623497997,343,1817,1075,742,104,239,0.608333333333,0.644213782691,0.644213782691
17,1,5,0.241624365482,0.903829787234,0.678062678063,0.587064676617,0.35628742515,0.711796246649,351,1809,1062,747,113,238,0.601851851852,0.63256367734,0.63256367734
17,1,6,0.254745254745,0.917169974116,0.726495726496,0.587617468214,0.377218934911,0.716307277628,351,1809,1063,746,96,255,0.610185185185,0.657056597355,0.657056597355
17,1,7,0.245128205128,0.908016877637,0.686781609195,0.593818984547,0.361300075586,0.718051384718,348,1812,1076,736,109,239,0.608796296296,0.640300296871,0.640300296871
17,1,8,0.242655059848,0.904915390814,0.653958944282,0.617372182518,0.353968253968,0.733986928105,341,1819,1123,696,118,223,0.623148148148,0.6356655634,0.6356655634
17,1,9,0.242331288344,0.912013536379,0.695014662757,0.592633315008,0.359363153904,0.718427190936,341,1819,1078,741,104,237,0.608796296296,0.643823988882,0.643823988882
17,1,10,0.250814332248,0.91202582728,0.679411764706,0.620879120879,0.366375892149,0.738803530566,340,1820,1130,690,109,231,0.630092592593,0.650145442793,0.650145442793
17,1,11,0.255555555556,0.918803418803,0.727011494253,0.593267108168,0.378176382661,0.720992622401,348,1812,1075,737,95,253,0.614814814815,0.66013930121,0.66013930121
17,1,12,0.217576791809,0.919028340081,0.761194029851,0.497534246575,0.338420703384,0.645574120156,335,1825,908,917,80,255,0.538425925926,0.629364138213,0.629364138213
17,1,13,0.23119266055,0.911214953271,0.726224783862,0.53778268064,0.350730688935,0.676378772112,347,1813,975,838,95,252,0.568055555556,0.632003732251,0.632003732251
17,1,14,0.247,0.920689655172,0.728613569322,0.586490939044,0.368932038835,0.716538074472,339,1821,1068,753,92,247,0.608796296296,0.657552254183,0.657552254183
17,1,15,0.242224316682,0.926296633303,0.760355029586,0.558726673985,0.367405289492,0.697021567956,338,1822,1018,804,81,257,0.590277777778,0.659540851785,0.659540851785
17,1,16,0.227191413238,0.923224568138,0.760479041916,0.526834611172,0.349862258953,0.670850767085,334,1826,962,864,80,254,0.562962962963,0.643656826544,0.643656826544
17,1,17,0.225650916104,0.908281389136,0.694362017804,0.55951727921,0.340611353712,0.692464358452,337,1823,1020,803,103,234,0.580555555556,0.626939648507,0.626939648507
17,1,18,0.238049713193,0.917414721724,0.730205278592,0.561847168774,0.359048305696,0.696897374702,341,1819,1022,797,92,249,0.588425925926,0.646026223683,0.646026223683
17,1,19,0.228436018957,0.915837104072,0.721556886228,0.55421686747,0.347012239021,0.69054930058,334,1826,1012,814,93,241,0.580092592593,0.637886876849,0.637886876849
17,1,20,0.25078369906,0.915211970075,0.701754385965,0.605610561056,0.369515011547,0.728897715988,342,1818,1101,717,102,240,0.620833333333,0.653682473511,0.653682473511
17,1,21,0.245454545455,0.920512820513,0.723214285714,0.590460526316,0.366515837104,0.719438877756,336,1824,1077,747,93,243,0.611111111111,0.656837406015,0.656837406015
17,1,22,0.252714708786,0.918918918919,0.733524355301,0.581998895638,0.375917767988,0.712643678161,349,1811,1054,757,93,256,0.606481481481,0.657761625469,0.657761625469
17,1,23,0.237305699482,0.91129707113,0.683582089552,0.596712328767,0.352307692308,0.72119205298,335,1825,1089,736,106,229,0.610185185185,0.64014720916,0.64014720916
17,1,24,0.236097560976,0.913656387665,0.711764705882,0.56978021978,0.354578754579,0.701861252115,340,1820,1037,783,98,242,0.59212962963,0.640772462831,0.640772462831
17,1,25,0.244267198405,0.910112359551,0.702005730659,0.581446714522,0.362426035503,0.709568733154,349,1811,1053,758,104,245,0.600925925926,0.641726222591,0.641726222591
17,1,26,0.256355932203,0.916118421053,0.703488372093,0.613436123348,0.375776397516,0.734828496042,344,1816,1114,702,102,242,0.627777777778,0.658462247721,0.658462247721
17,1,27,0.238095238095,0.910485933504,0.691176470588,0.586813186813,0.35418236624,0.713665218844,340,1820,1068,752,105,235,0.603240740741,0.638994828701,0.638994828701
17,1,28,0.250253292806,0.913043478261,0.707736389685,0.5913859746,0.369760479042,0.717828418231,349,1811,1071,740,102,247,0.610185185185,0.649561182142,0.649561182142
17,1,29,0.254620123203,0.919898819562,0.723032069971,0.600440286186,0.376613515566,0.726606726607,343,1817,1091,726,95,248,0.619907407407,0.661736178078,0.661736178078
17,1,30,0.232158988257,0.920227920228,0.75366568915,0.532710280374,0.354972375691,0.674791086351,341,1819,969,850,84,257,0.567592592593,0.643187984762,0.643187984762
17,1,31,0.240609137056,0.904680851064,0.679083094556,0.586968525676,0.355322338831,0.711989283322,349,1811,1063,748,112,237,0.601851851852,0.633025810116,0.633025810116
17,1,32,0.237810945274,0.911688311688,0.700879765396,0.578889499725,0.355126300149,0.708137188971,341,1819,1053,766,102,239,0.598148148148,0.639884632561,0.639884632561
17,1,33,0.255623721881,0.914551607445,0.712250712251,0.597567716971,0.376222723853,0.722835172183,351,1809,1081,728,101,250,0.616203703704,0.654909214611,0.654909214611
17,1,34,0.231123388582,0.911545623836,0.725433526012,0.539691289967,0.350558659218,0.677977839335,346,1814,979,835,95,251,0.569444444444,0.632562407989,0.632562407989
17,1,35,0.225092250923,0.907063197026,0.709302325581,0.537444933921,0.341736694678,0.674965421853,344,1816,976,840,100,244,0.564814814815,0.623373629751,0.623373629751
17,1,36,0.238001958864,0.91132572432,0.706395348837,0.571585903084,0.356043956044,0.702538071066,344,1816,1038,778,101,243,0.593055555556,0.63899062596,0.63899062596
17,1,37,0.24692526017,0.922030825023,0.752161383285,0.560948703806,0.371794871795,0.697530864198,347,1813,1017,796,86,261,0.591666666667,0.656555043546,0.656555043546
17,1,38,0.237585199611,0.908208296558,0.701149425287,0.567880794702,0.354909090909,0.698811544992,348,1812,1029,783,104,244,0.589351851852,0.634515109995,0.634515109995
17,1,39,0.248190279214,0.919530595138,0.714285714286,0.601425438596,0.368380660015,0.727212462711,336,1824,1097,727,96,240,0.618981481481,0.657855576441,0.657855576441
17,1,40,0.239195979899,0.910729613734,0.695906432749,0.583608360836,0.356020942408,0.711364398257,342,1818,1061,757,104,238,0.601388888889,0.639757396792,0.639757396792
17,1,41,0.23754789272,0.920250896057,0.73590504451,0.563357103675,0.359160028965,0.698877169105,337,1823,1027,796,89,248,0.590277777778,0.649631074093,0.649631074093
17,1,42,0.232125367287,0.909569798068,0.697058823529,0.569230769231,0.348273328435,0.700236566408,340,1820,1036,784,103,237,0.589351851852,0.63314479638,0.63314479638
17,1,43,0.240223463687,0.914364640884,0.735042735043,0.548922056385,0.362105263158,0.686010362694,351,1809,993,816,93,258,0.579166666667,0.641982395714,0.641982395714
17,1,44,0.254376930999,0.910849453322,0.699716713881,0.599335915883,0.373111782477,0.722963951936,353,1807,1083,724,106,247,0.615740740741,0.649526314882,0.649526314882
17,1,45,0.233082706767,0.908759124088,0.712643678161,0.549668874172,0.351274787535,0.685006877579,348,1812,996,816,100,248,0.575925925926,0.631156276167,0.631156276167
17,1,46,0.230700976043,0.910939012585,0.738636363636,0.52046460177,0.351588911427,0.66244280183,352,1808,941,867,92,260,0.556018518519,0.629550482703,0.629550482703
17,1,47,0.242829827916,0.915619389587,0.729885057471,0.562913907285,0.364418938307,0.697197539303,348,1812,1020,792,94,254,0.589814814815,0.646399482378,0.646399482378
17,1,48,0.237451737452,0.906583629893,0.700854700855,0.563294637922,0.354722422495,0.694851687692,351,1809,1019,790,105,246,0.585648148148,0.632074669388,0.632074669388
17,1,49,0.244466800805,0.913379073756,0.706395348837,0.586453744493,0.363228699552,0.714285714286,344,1816,1065,751,101,243,0.605555555556,0.646424546665,0.646424546665
17,1,50,0.237288135593,0.918032786885,0.736842105263,0.554455445545,0.358974358974,0.691358024691,342,1818,1008,810,90,252,0.583333333333,0.645648775404,0.645648775404
17,1,51,0.264131551901,0.921651221567,0.734285714286,0.604419889503,0.38851095994,0.73006339673,350,1810,1094,716,93,257,0.625462962963,0.669352801894,0.669352801894
17,1,52,0.236988847584,0.913284132841,0.730659025788,0.546659304252,0.357894736842,0.683937823834,349,1811,990,821,94,255,0.576388888889,0.63865916502,0.63865916502
17,1,53,0.235867446394,0.914462081129,0.713864306785,0.569467325645,0.354578754579,0.701861252115,339,1821,1037,784,97,242,0.59212962963,0.641665816215,0.641665816215
17,1,54,0.238691049086,0.917038358608,0.727272727273,0.565145684442,0.359420289855,0.699319727891,341,1819,1028,791,93,248,0.590740740741,0.646209205857,0.646209205857
17,1,55,0.235349716446,0.904718693285,0.703389830508,0.552048726467,0.35269121813,0.685694635488,354,1806,997,809,105,249,0.576851851852,0.627719278488,0.627719278488
17,1,56,0.254995242626,0.92515779982,0.763532763533,0.567164179104,0.382310984308,0.70322138451,351,1809,1026,783,83,268,0.599074074074,0.665348471319,0.665348471319
17,1,57,0.256306760848,0.91873396065,0.727793696275,0.593042517946,0.379104477612,0.720805369128,349,1811,1074,737,95,254,0.614814814815,0.66041810711,0.66041810711
17,1,58,0.233463035019,0.910777385159,0.703812316716,0.566794942276,0.350620891161,0.698746187733,341,1819,1031,788,101,240,0.588425925926,0.635303629496,0.635303629496
17,1,59,0.246348588121,0.917917034422,0.731213872832,0.573318632856,0.36853605244,0.705802511028,346,1814,1040,774,93,253,0.598611111111,0.652266252844,0.652266252844
17,1,60,0.254817987152,0.914355628059,0.69387755102,0.616951018162,0.372748629601,0.736772921459,343,1817,1121,696,105,238,0.629166666667,0.655414284591,0.655414284591
17,1,61,0.246406570842,0.911467116358,0.695652173913,0.595592286501,0.363912054587,0.720426524492,345,1815,1081,734,105,240,0.611574074074,0.645622230207,0.645622230207
17,1,62,0.236430542778,0.914259086673,0.736389684814,0.541689674213,0.357938718663,0.680305131761,349,1811,981,830,92,257,0.573148148148,0.639039679513,0.639039679513
17,1,63,0.24503968254,0.911458333333,0.707736389685,0.579790171176,0.364038319823,0.708741140736,349,1811,1050,761,102,247,0.600462962963,0.64376328043,0.64376328043
17,1,64,0.244532803181,0.908145580589,0.698863636364,0.579646017699,0.362297496318,0.707629979743,352,1808,1048,760,106,246,0.599074074074,0.639254827031,0.639254827031
17,1,65,0.250237868696,0.920649233544,0.749287749288,0.564400221117,0.37517831669,0.699794379712,351,1809,1021,788,88,263,0.594444444444,0.656843985202,0.656843985202
17,1,66,0.247,0.910344827586,0.703703703704,0.583747927032,0.365655070318,0.711350623105,351,1809,1056,753,104,247,0.603240740741,0.643725815368,0.643725815368
17,1,67,0.245463228271,0.905660377358,0.709944751381,0.560622914349,0.364797728886,0.692545517004,362,1798,1008,790,105,257,0.585648148148,0.635283832865,0.635283832865
17,1,68,0.245508982036,0.916234887737,0.717201166181,0.58392955421,0.365799256506,0.713277310924,343,1817,1061,756,97,246,0.605092592593,0.650565360195,0.650565360195
17,1,69,0.262419006479,0.916531604538,0.702312138728,0.62348401323,0.382075471698,0.742125984252,346,1814,1131,683,103,243,0.636111111111,0.662898075979,0.662898075979
17,1,70,0.25282631038,0.923336141533,0.729970326409,0.601206801975,0.375572519084,0.728239202658,337,1823,1096,727,91,246,0.621296296296,0.665588564192,0.665588564192
17,1,71,0.257111597374,0.913322632424,0.685131195335,0.626307099615,0.373906125696,0.743062357166,343,1817,1138,679,108,235,0.635648148148,0.655719147475,0.655719147475
17,1,72,0.229717411121,0.914393226717,0.734693877551,0.534947716015,0.35,0.675,343,1817,972,845,91,252,0.566666666667,0.634820796783,0.634820796783
17,1,73,0.250764525994,0.909245122986,0.696883852691,0.593248478141,0.368815592204,0.718017414601,353,1807,1072,735,107,246,0.610185185185,0.645066165416,0.645066165416
17,1,74,0.254098360656,0.910472972973,0.700564971751,0.596899224806,0.372932330827,0.721070234114,354,1806,1078,728,106,248,0.613888888889,0.648732098279,0.648732098279
17,1,75,0.236842105263,0.918795620438,0.739002932551,0.553600879604,0.35871886121,0.690909090909,341,1819,1007,812,89,252,0.58287037037,0.646301906078,0.646301906078
17,1,76,0.246575342466,0.915641476274,0.724137931034,0.575055187638,0.367883211679,0.706440677966,348,1812,1042,770,96,252,0.599074074074,0.649596559336,0.649596559336
17,1,77,0.240077444337,0.914818101154,0.720930232558,0.567731277533,0.360203340595,0.700645599728,344,1816,1031,785,96,248,0.59212962963,0.644330755046,0.644330755046
17,1,78,0.221463414634,0.901321585903,0.669616519174,0.561779242175,0.33284457478,0.692151556157,339,1821,1023,798,112,227,0.578703703704,0.615697880674,0.615697880674
17,1,79,0.243055555556,0.915798611111,0.716374269006,0.580308030803,0.362962962963,0.710437710438,342,1818,1055,763,97,245,0.601851851852,0.648341149904,0.648341149904
17,1,80,0.253451676529,0.922338568935,0.742774566474,0.582690187431,0.377941176471,0.714189189189,346,1814,1057,757,89,257,0.608333333333,0.662732376953,0.662732376953
17,1,81,0.24739039666,0.905158069884,0.675213675214,0.601437258154,0.362108479756,0.722683493856,351,1809,1088,721,114,237,0.613425925926,0.638325466684,0.638325466684
17,1,82,0.240339302545,0.922656960874,0.75,0.557142857143,0.364025695931,0.694758478931,340,1820,1014,806,85,255,0.5875,0.653571428571,0.653571428571
17,1,83,0.241035856574,0.914359861592,0.709677419355,0.58108851017,0.359851301115,0.710588235294,341,1819,1057,762,99,242,0.601388888889,0.645382964763,0.645382964763
17,1,84,0.245187436677,0.907928388747,0.691428571429,0.588397790055,0.362004487659,0.714046262152,350,1810,1065,745,108,242,0.605092592593,0.639913180742,0.639913180742
17,1,85,0.234435797665,0.916961130742,0.719402985075,0.568767123288,0.353631694791,0.702062901589,335,1825,1038,787,94,241,0.59212962963,0.644085054181,0.644085054181
17,1,86,0.268156424581,0.909881422925,0.677966101695,0.637320044297,0.384307445957,0.74959296646,354,1806,1151,655,114,240,0.643981481481,0.657643072996,0.657643072996
17,1,87,0.240615976901,0.920606601249,0.737463126844,0.566721581549,0.362844702467,0.701563562203,339,1821,1032,789,89,250,0.593518518519,0.652092354196,0.652092354196
17,1,88,0.254395036194,0.918692372171,0.717201166181,0.603192074849,0.375572519084,0.728239202658,343,1817,1096,721,97,246,0.621296296296,0.660196620515,0.660196620515
17,1,89,0.226126126126,0.91619047619,0.740412979351,0.528281164195,0.346445824707,0.670149773598,339,1821,962,859,88,251,0.561574074074,0.634347071773,0.634347071773
17,1,90,0.238679245283,0.915454545455,0.731213872832,0.555126791621,0.359886201991,0.691146190803,346,1814,1007,807,93,253,0.583333333333,0.643170332227,0.643170332227
17,1,91,0.240758293839,0.92036199095,0.74269005848,0.559405940594,0.363636363636,0.695860417379,342,1818,1017,801,88,254,0.588425925926,0.651047999537,0.651047999537
17,1,92,0.236598890943,0.923005565863,0.755162241888,0.546403075233,0.360309641098,0.686443601242,339,1821,995,826,83,256,0.579166666667,0.650782658561,0.650782658561
17,1,93,0.23842364532,0.910917030568,0.703488372093,0.574339207048,0.356144223694,0.704491725768,344,1816,1043,773,102,242,0.594907407407,0.638913789571,0.638913789571
17,1,94,0.242931937173,0.903734439834,0.666666666667,0.600993377483,0.356101304682,0.721909181306,348,1812,1089,723,116,232,0.611574074074,0.633830022075,0.633830022075
17,1,95,0.227657572907,0.917958067457,0.728915662651,0.550875273523,0.346953405018,0.688547008547,332,1828,1007,821,90,242,0.578240740741,0.639895468087,0.639895468087
17,1,96,0.243137254902,0.915789473684,0.720930232558,0.574889867841,0.363636363636,0.706359945873,344,1816,1044,772,96,248,0.598148148148,0.6479100502,0.6479100502
17,1,97,0.237209302326,0.9133640553,0.730659025788,0.547211485367,0.358146067416,0.684392265193,349,1811,991,820,94,255,0.576851851852,0.638935255578,0.638935255578
17,1,98,0.263485477178,0.91889632107,0.723646723647,0.607517965727,0.386311787072,0.731447587354,351,1809,1099,710,97,254,0.626388888889,0.665582344687,0.665582344687
17,1,99,0.241935483871,0.913200723327,0.726495726496,0.558319513543,0.362989323843,0.692967409949,351,1809,1010,799,96,255,0.585648148148,0.64240762002,0.64240762002
19,1,0,0.237762237762,0.911993097498,0.7,0.580769230769,0.354958985831,0.709634105404,340,1820,1057,763,102,238,0.599537037037,0.640384615385,0.640384615385
19,1,1,0.250248262165,0.919340849957,0.730434782609,0.584022038567,0.372781065089,0.714285714286,345,1815,1060,755,93,252,0.607407407407,0.657228410588,0.657228410588
19,1,2,0.235410484669,0.910356832028,0.697947214076,0.575041231446,0.352071005917,0.704851752022,341,1819,1046,773,103,238,0.594444444444,0.636494222761,0.636494222761
19,1,3,0.239028944911,0.909090909091,0.721126760563,0.548476454294,0.35904628331,0.684174153421,355,1805,990,815,99,256,0.576851851852,0.634801607429,0.634801607429
19,1,4,0.240663900415,0.907190635452,0.67638483965,0.597138139791,0.355011476664,0.720212412878,343,1817,1085,732,111,232,0.609722222222,0.636761489721,0.636761489721
19,1,5,0.263713080169,0.917491749175,0.714285714286,0.614364640884,0.385208012327,0.735936465917,350,1810,1112,698,100,250,0.630555555556,0.664325177585,0.664325177585
19,1,6,0.245222929936,0.912972085386,0.685459940653,0.609983543609,0.361219702893,0.731338375534,337,1823,1112,711,106,231,0.621759259259,0.647721742131,0.647721742131
19,1,7,0.242334322453,0.913838120104,0.712209302326,0.578193832599,0.361623616236,0.70826306914,344,1816,1050,766,99,245,0.599537037037,0.645201567462,0.645201567462
19,1,8,0.220640569395,0.912162162162,0.731563421829,0.518945634267,0.339029391661,0.661533076654,339,1821,945,876,91,248,0.552314814815,0.625254528048,0.625254528048
19,1,9,0.238540692236,0.914757103575,0.73275862069,0.550772626932,0.359915314044,0.687564588357,348,1812,998,814,93,255,0.580092592593,0.641765623811,0.641765623811
19,1,10,0.234159779614,0.915966386555,0.739130434783,0.540495867769,0.355648535565,0.679833679834,345,1815,981,834,90,255,0.572222222222,0.639813151276,0.639813151276
19,1,11,0.244549763033,0.930316742081,0.770149253731,0.563287671233,0.371223021583,0.701706484642,335,1825,1028,797,77,258,0.59537037037,0.666718462482,0.666718462482
19,1,12,0.237574552684,0.913344887348,0.705014749263,0.578802855574,0.355390334572,0.708571428571,339,1821,1054,767,100,239,0.598611111111,0.641908802418,0.641908802418
19,1,13,0.238603297769,0.911426040744,0.71098265896,0.567254685777,0.357298474946,0.699286442406,346,1814,1029,785,100,246,0.590277777778,0.639118672368,0.639118672368
19,1,14,0.255863539446,0.915711947627,0.69970845481,0.615850302697,0.374707259953,0.736426456071,343,1817,1119,698,103,240,0.629166666667,0.657779378754,0.657779378754
19,1,15,0.240234375,0.919014084507,0.727810650888,0.572996706915,0.361233480176,0.705882352941,338,1822,1044,778,92,246,0.597222222222,0.650403678902,0.650403678902
19,1,16,0.239962651727,0.925619834711,0.760355029586,0.55323819978,0.364797728886,0.692545517004,338,1822,1008,814,81,257,0.585648148148,0.656796614683,0.656796614683
19,1,17,0.252736318408,0.920346320346,0.734104046243,0.585997794928,0.376017764619,0.716066015493,346,1814,1063,751,92,254,0.609722222222,0.660050920586,0.660050920586
19,1,18,0.239371534196,0.91094619666,0.729577464789,0.54404432133,0.360473208072,0.681234824835,355,1805,982,823,96,259,0.574537037037,0.636810893059,0.636810893059
19,1,19,0.246681415929,0.906050955414,0.653958944282,0.625618471688,0.358232931727,0.740162601626,341,1819,1138,681,118,223,0.630092592593,0.639788707985,0.639788707985
19,1,20,0.247290640394,0.918777292576,0.729651162791,0.579295154185,0.369389256806,0.710570753124,344,1816,1052,764,93,251,0.603240740741,0.654473158488,0.654473158488
19,1,21,0.243349753695,0.917903930131,0.724340175953,0.577789994502,0.364306784661,0.709176788124,341,1819,1051,768,94,247,0.600925925926,0.651065085228,0.651065085228
19,1,22,0.25126135217,0.922155688623,0.732352941176,0.592307692308,0.374154770849,0.72131147541,340,1820,1078,742,91,249,0.614351851852,0.662330316742,0.662330316742
19,1,23,0.237104072398,0.922274881517,0.761627906977,0.535792951542,0.361628709455,0.677812608847,344,1816,973,843,82,262,0.571759259259,0.648710429259,0.648710429259
19,1,24,0.239962651727,0.921946740129,0.751461988304,0.552255225523,0.363765038924,0.690746474028,342,1818,1004,814,85,257,0.583796296296,0.651858606913,0.651858606913
19,1,25,0.233394833948,0.920074349442,0.746312684366,0.543657331137,0.355586788475,0.683465654125,339,1821,990,831,86,253,0.575462962963,0.644985007751,0.644985007751
19,1,26,0.231299212598,0.912587412587,0.701492537313,0.572054794521,0.347890451517,0.703267093297,335,1825,1044,781,100,235,0.59212962963,0.636773665917,0.636773665917
19,1,27,0.248995983936,0.919243986254,0.72514619883,0.588558855886,0.370702541106,0.717639168343,342,1818,1070,748,94,248,0.610185185185,0.656852527358,0.656852527358
19,1,28,0.231187669991,0.922421948912,0.756676557864,0.534832693363,0.354166666667,0.677083333333,337,1823,975,848,82,255,0.569444444444,0.645754625613,0.645754625613
19,1,29,0.245595854922,0.918828451883,0.709580838323,0.601314348302,0.364896073903,0.726911618669,334,1826,1098,728,97,237,0.618055555556,0.655447593313,0.655447593313
19,1,30,0.241170534813,0.914456800684,0.705014749263,0.587040087864,0.359398496241,0.715050167224,339,1821,1069,752,100,239,0.605555555556,0.646027418563,0.646027418563
19,1,31,0.250524109015,0.915422885572,0.700879765396,0.606926882903,0.369111969112,0.729917355372,341,1819,1104,715,102,239,0.621759259259,0.653903324149,0.653903324149
19,1,32,0.244536940687,0.907422852377,0.679190751445,0.599779492834,0.359602142311,0.722203783604,346,1814,1088,726,111,235,0.6125,0.639485122139,0.639485122139
19,1,33,0.231404958678,0.916900093371,0.739002932551,0.539857064321,0.352447552448,0.679584775087,341,1819,982,837,89,252,0.571296296296,0.639429998436,0.639429998436
19,1,34,0.230097087379,0.90796460177,0.695014662757,0.564046179219,0.345733041575,0.695829094608,341,1819,1026,793,104,237,0.584722222222,0.629530420988,0.629530420988
19,1,35,0.228460793804,0.912156166815,0.70447761194,0.563287671233,0.345029239766,0.69647696477,335,1825,1028,797,99,236,0.585185185185,0.633882641587,0.633882641587
19,1,36,0.250749250749,0.919758412425,0.729651162791,0.587004405286,0.373234200743,0.716638655462,344,1816,1066,750,93,251,0.609722222222,0.658327784039,0.658327784039
19,1,37,0.242481203008,0.917883211679,0.741379310345,0.555187637969,0.365439093484,0.691884456671,348,1812,1006,806,90,258,0.585185185185,0.648283474157,0.648283474157
19,1,38,0.252288911495,0.908241291419,0.696629213483,0.592572062084,0.370425690814,0.717208990272,356,1804,1069,735,108,248,0.609722222222,0.644600637784,0.644600637784
19,1,39,0.250515463918,0.918487394958,0.714705882353,0.600549450549,0.370992366412,0.726245847176,340,1820,1093,727,97,243,0.618518518519,0.657627666451,0.657627666451
19,1,40,0.242331288344,0.917089678511,0.707462686567,0.59397260274,0.361005331302,0.720984369804,335,1825,1084,741,98,237,0.611574074074,0.650717644653,0.650717644653
19,1,41,0.23352165725,0.921675774135,0.74251497006,0.55421686747,0.355300859599,0.69220246238,334,1826,1012,814,86,248,0.583333333333,0.648365918765,0.648365918765
19,1,42,0.245421245421,0.926029962547,0.772334293948,0.545504688362,0.372480889507,0.686567164179,347,1813,989,824,79,268,0.581944444444,0.658919491155,0.658919491155
19,1,43,0.241869918699,0.91156462585,0.695906432749,0.589658965897,0.358974358974,0.716098864395,342,1818,1072,746,104,238,0.606481481481,0.642782699323,0.642782699323
19,1,44,0.265111346766,0.915365653246,0.70821529745,0.616491422247,0.385802469136,0.736772486772,353,1807,1114,693,103,250,0.631481481481,0.662353359849,0.662353359849
19,1,45,0.234683281412,0.903926482874,0.66275659824,0.594832325454,0.346625766871,0.7175066313,341,1819,1082,737,115,226,0.605555555556,0.628794461847,0.628794461847
19,1,46,0.251256281407,0.915021459227,0.716332378223,0.588625069023,0.372023809524,0.716397849462,349,1811,1066,745,99,250,0.609259259259,0.652478723623,0.652478723623
19,1,47,0.246290801187,0.924281984334,0.741071428571,0.582236842105,0.369710467706,0.714429868819,336,1824,1062,762,87,249,0.606944444444,0.661654135338,0.661654135338
19,1,48,0.236399604352,0.912097476066,0.702941176471,0.575824175824,0.353811991118,0.705961603233,340,1820,1048,772,101,239,0.595833333333,0.639382676147,0.639382676147
19,1,49,0.244102564103,0.914767932489,0.702064896755,0.595277320154,0.362252663623,0.72122421823,339,1821,1084,737,101,238,0.612037037037,0.648671108454,0.648671108454
19,1,50,0.243654822335,0.914042553191,0.703812316716,0.590434304563,0.361990950226,0.717434869739,341,1819,1074,745,101,240,0.608333333333,0.647123310639,0.647123310639
19,1,51,0.229187071499,0.914837576822,0.706948640483,0.569710224166,0.346153846154,0.702156334232,331,1829,1042,787,97,234,0.590740740741,0.638329432325,0.638329432325
19,1,52,0.242698892246,0.916880891174,0.713017751479,0.587266739846,0.362133734035,0.715958514553,338,1822,1070,752,97,241,0.606944444444,0.650142245663,0.650142245663
19,1,53,0.23119266055,0.917757009346,0.741176470588,0.53956043956,0.352447552448,0.679584775087,340,1820,982,838,88,252,0.571296296296,0.640368455074,0.640368455074
19,1,54,0.250251256281,0.915021459227,0.715517241379,0.588300220751,0.370811615786,0.71615720524,348,1812,1066,746,99,249,0.608796296296,0.651908731065,0.651908731065
19,1,55,0.241967871486,0.912371134021,0.702623906706,0.584479911943,0.35997012696,0.712512579671,343,1817,1062,755,102,241,0.603240740741,0.643551909324,0.643551909324
19,1,56,0.24925224327,0.913569576491,0.714285714286,0.583977900552,0.369549150037,0.71250421301,350,1810,1057,753,100,250,0.605092592593,0.649131807419,0.649131807419
19,1,57,0.237696335079,0.914522821577,0.687878787879,0.60218579235,0.353307392996,0.726194398682,330,1830,1102,728,103,227,0.615277777778,0.645032290114,0.645032290114
19,1,58,0.247156153051,0.917854149204,0.709198813056,0.600658255623,0.366564417178,0.726127320955,337,1823,1095,728,98,239,0.617592592593,0.654928534339,0.654928534339
19,1,59,0.240077444337,0.908606921029,0.706552706553,0.566058595909,0.35838150289,0.697547683924,351,1809,1024,785,103,248,0.588888888889,0.636305651231,0.636305651231
19,1,60,0.232245681382,0.914132379249,0.715976331361,0.560922063666,0.350724637681,0.695238095238,338,1822,1022,800,96,242,0.585185185185,0.638449197514,0.638449197514
19,1,61,0.2421875,0.912852112676,0.71469740634,0.571980143409,0.36177972283,0.703289250593,347,1813,1037,776,99,248,0.594907407407,0.643338774874,0.643338774874
19,1,62,0.251059322034,0.917763157895,0.703264094955,0.612177729018,0.370023419204,0.734452122409,337,1823,1116,707,100,237,0.626388888889,0.657720911987,0.657720911987
19,1,63,0.241071428571,0.914930555556,0.712609970674,0.579439252336,0.360266864344,0.709525412319,341,1819,1054,765,98,243,0.600462962963,0.646024611505,0.646024611505
19,1,64,0.235867446394,0.913580246914,0.711764705882,0.569230769231,0.354319180088,0.701421800948,340,1820,1036,784,98,242,0.591666666667,0.640497737557,0.640497737557
19,1,65,0.246534653465,0.914782608696,0.71757925072,0.580253723111,0.366985998526,0.710091123861,347,1813,1052,761,98,249,0.602314814815,0.648916486916,0.648916486916
19,1,66,0.24976076555,0.926457399103,0.760932944606,0.5685195377,0.376080691643,0.704638472033,343,1817,1033,784,82,261,0.599074074074,0.664726241153,0.664726241153
19,1,67,0.227355072464,0.910037878788,0.725433526012,0.529768467475,0.346206896552,0.66968641115,346,1814,961,853,95,251,0.561111111111,0.627600996743,0.627600996743
19,1,68,0.245614035088,0.917107583774,0.728323699422,0.573318632856,0.367346938776,0.705563093623,346,1814,1040,774,94,252,0.598148148148,0.650821166139,0.650821166139
19,1,69,0.244776119403,0.912554112554,0.708933717579,0.581356867071,0.363905325444,0.710242587601,347,1813,1054,759,101,246,0.601851851852,0.645145292325,0.645145292325
19,1,70,0.231412639405,0.907749077491,0.713467048711,0.543346217559,0.349473684211,0.679792746114,349,1811,984,827,100,249,0.570833333333,0.628406633135,0.628406633135
19,1,71,0.238317757009,0.918348623853,0.741279069767,0.551211453744,0.360678925035,0.688919476944,344,1816,1001,815,89,255,0.581481481481,0.646245261756,0.646245261756
19,1,72,0.24557956778,0.9176882662,0.726744186047,0.577092511013,0.367107195301,0.708586883029,344,1816,1048,768,94,250,0.600925925926,0.65191834853,0.65191834853
19,1,73,0.230839416058,0.922932330827,0.755223880597,0.538082191781,0.353598881901,0.679820006923,335,1825,982,843,82,253,0.571759259259,0.646653036189,0.646653036189
19,1,74,0.232602478551,0.913591359136,0.717647058824,0.557692307692,0.351331893449,0.692596383487,340,1820,1015,805,96,244,0.58287037037,0.637669683258,0.637669683258
19,1,75,0.242757242757,0.909404659189,0.698275862069,0.581677704194,0.360266864344,0.709525412319,348,1812,1054,758,105,243,0.600462962963,0.639976783132,0.639976783132
19,1,76,0.243512974052,0.90932642487,0.699140401146,0.581446714522,0.361213915618,0.709329740653,349,1811,1053,758,105,244,0.600462962963,0.640293557834,0.640293557834
19,1,77,0.245428296439,0.917930419269,0.734870317003,0.567567567568,0.367965367965,0.701431492843,347,1813,1029,784,92,255,0.594444444444,0.651218942285,0.651218942285
19,1,78,0.236578707916,0.919886899152,0.753623188406,0.537741046832,0.360110803324,0.678720445063,345,1815,976,839,85,260,0.572222222222,0.645682117619,0.645682117619
19,1,79,0.235849056604,0.908789386401,0.671641791045,0.600547945205,0.349107835531,0.723193665457,335,1825,1096,729,110,225,0.611574074074,0.636094868125,0.636094868125
19,1,80,0.233653846154,0.908928571429,0.704347826087,0.5608815427,0.350902527076,0.693696763203,345,1815,1018,797,102,243,0.583796296296,0.632614684393,0.632614684393
19,1,81,0.239661654135,0.923357664234,0.752212389381,0.555738605162,0.363506771205,0.69386355845,339,1821,1012,809,84,255,0.586574074074,0.653975497271,0.653975497271
19,1,82,0.243270189432,0.909248055315,0.699140401146,0.580894533407,0.360946745562,0.708894878706,349,1811,1052,759,105,244,0.6,0.640017467277,0.640017467277
19,1,83,0.261401557286,0.91435368755,0.685131195335,0.634562465603,0.378421900161,0.749187784276,343,1817,1153,664,108,235,0.642592592593,0.659846830469,0.659846830469
19,1,84,0.234151329243,0.910321489002,0.683582089552,0.589589041096,0.348819497334,0.715663451945,335,1825,1076,749,106,229,0.604166666667,0.636585565324,0.636585565324
19,1,85,0.249498997996,0.913941480207,0.713467048711,0.586416344561,0.369710467706,0.714429868819,349,1811,1062,749,100,249,0.606944444444,0.649941696636,0.649941696636
19,1,86,0.236506378803,0.910604732691,0.702623906706,0.571821684095,0.35389133627,0.702501690331,343,1817,1039,778,102,241,0.592592592593,0.6372227954,0.6372227954
19,1,87,0.236529680365,0.921126760563,0.755102040816,0.539900935608,0.360222531293,0.680777238029,343,1817,981,836,84,259,0.574074074074,0.647501488212,0.647501488212
19,1,88,0.2374749499,0.907917383821,0.688953488372,0.580947136564,0.353204172876,0.708529214238,344,1816,1055,761,107,237,0.598148148148,0.634950312468,0.634950312468
19,1,89,0.240975609756,0.914537444934,0.718023255814,0.571585903084,0.36084733382,0.703490342257,344,1816,1038,778,97,247,0.594907407407,0.644804579449,0.644804579449
19,1,90,0.261585993821,0.922624053827,0.734104046243,0.604740904079,0.385725132878,0.730602730603,346,1814,1097,717,92,254,0.625462962963,0.669422475161,0.669422475161
19,1,91,0.233364573571,0.91582799634,0.730205278592,0.550302363936,0.353693181818,0.6875,341,1819,1001,818,92,249,0.578703703704,0.640253821264,0.640253821264
19,1,92,0.22625698324,0.912523020258,0.718934911243,0.543907793633,0.344192634561,0.681568088033,338,1822,991,831,95,243,0.571296296296,0.631421352438,0.631421352438
19,1,93,0.25,0.922743055556,0.739002932551,0.584387025838,0.373610081542,0.715583978458,341,1819,1063,756,89,252,0.608796296296,0.661694979195,0.661694979195
19,1,94,0.240704500978,0.908611599297,0.702857142857,0.571270718232,0.35860058309,0.701492537313,350,1810,1034,776,104,246,0.592592592593,0.637063930545,0.637063930545
19,1,95,0.262376237624,0.926956521739,0.759312320917,0.588625069023,0.389992641648,0.720027017899,349,1811,1066,745,84,265,0.616203703704,0.67396869497,0.67396869497
19,1,96,0.242738589212,0.91220735786,0.690265486726,0.599121361889,0.359171143515,0.723235001657,339,1821,1091,730,105,234,0.613425925926,0.644693424307,0.644693424307
19,1,97,0.231649189704,0.915391539154,0.721068249258,0.557871640154,0.350649350649,0.693251533742,337,1823,1017,806,94,243,0.583333333333,0.639469944706,0.639469944706
19,1,98,0.240579710145,0.910222222222,0.711428571429,0.565745856354,0.359566787004,0.697785349233,350,1810,1024,786,101,249,0.589351851852,0.638587213891,0.638587213891
19,1,99,0.253715498938,0.912151067323,0.690751445087,0.612458654906,0.371118012422,0.732849604222,346,1814,1111,703,107,239,0.625,0.651605049996,0.651605049996
3,0,0,0.371900826446,0.871220020855,0.26706231454,0.916620954471,0.310880829016,0.893344025662,337,1823,1671,152,247,90,0.815277777778,0.591841634505,0.591841634505
3,0,1,0.403361344538,0.866285119667,0.271954674221,0.921416712784,0.324873096447,0.893000804505,353,1807,1665,142,257,96,0.815277777778,0.596685693502,0.596685693502
3,0,2,0.42731277533,0.869632695292,0.277936962751,0.928216454997,0.336805555556,0.89797008547,349,1811,1681,130,252,97,0.823148148148,0.603076708874,0.603076708874
3,0,3,0.397379912664,0.86846193682,0.263768115942,0.923966942149,0.317073170732,0.895355045382,345,1815,1677,138,254,91,0.818518518519,0.593867529045,0.593867529045
3,0,4,0.348178137652,0.867224255097,0.252941176471,0.911538461538,0.293015332198,0.888829359764,340,1820,1659,161,254,86,0.80787037037,0.582239819005,0.582239819005
3,0,5,0.387234042553,0.865454545455,0.26,0.92044198895,0.311111111111,0.892101740295,350,1810,1666,144,259,91,0.813425925926,0.590220994475,0.590220994475
3,0,6,0.382978723404,0.870649350649,0.265486725664,0.920373421197,0.313588850174,0.894821142552,339,1821,1676,145,249,90,0.817592592593,0.59293007343,0.59293007343
3,0,7,0.375,0.870798319328,0.280701754386,0.91199119912,0.321070234114,0.890918860828,342,1818,1658,160,246,96,0.812037037037,0.596346476753,0.596346476753
3,0,8,0.393162393162,0.867601246106,0.265129682997,0.92167677882,0.31669535284,0.893821877507,347,1813,1671,142,255,92,0.816203703704,0.593403230908,0.593403230908
3,0,9,0.412017167382,0.872340425532,0.280701754386,0.924642464246,0.333913043478,0.897730307076,342,1818,1681,137,246,96,0.822685185185,0.602672109316,0.602672109316
3,0,10,0.399122807018,0.869047619048,0.264534883721,0.924559471366,0.318181818182,0.895944503735,344,1816,1679,137,253,91,0.819444444444,0.594547177543,0.594547177543
3,0,11,0.384615384615,0.866043613707,0.258620689655,0.920529801325,0.309278350515,0.892455858748,348,1812,1668,144,258,90,0.813888888889,0.58957524549,0.58957524549
3,0,12,0.401709401709,0.865524402908,0.266288951841,0.922523519646,0.320272572402,0.893115456737,353,1807,1667,140,259,94,0.815277777778,0.594406235744,0.594406235744
3,0,13,0.363265306122,0.873107049608,0.268072289157,0.91466083151,0.30849220104,0.893401015228,332,1828,1672,156,243,89,0.815277777778,0.591366560333,0.591366560333
3,0,14,0.3875,0.872916666667,0.275964391691,0.919363686231,0.322357019064,0.895538338231,337,1823,1676,147,244,93,0.818981481481,0.597664038961,0.597664038961
3,0,15,0.371308016878,0.866874674987,0.255813953488,0.91795154185,0.302925989673,0.891682267986,344,1816,1667,149,256,88,0.8125,0.586882747669,0.586882747669
3,0,16,0.406392694064,0.867078825348,0.256484149856,0.928295642581,0.314487632509,0.896643580181,347,1813,1683,130,258,89,0.82037037037,0.592389896219,0.592389896219
3,0,17,0.399141630901,0.868707836015,0.268786127168,0.922822491731,0.321243523316,0.8949478749,346,1814,1674,140,253,93,0.818055555556,0.595804309449,0.595804309449
3,0,18,0.391111111111,0.866149870801,0.253602305476,0.92443463872,0.307692307692,0.894343649947,347,1813,1676,137,259,88,0.816666666667,0.589018472098,0.589018472098
3,0,19,0.419213973799,0.868979803211,0.275071633238,0.926559911651,0.332179930796,0.896846606093,349,1811,1678,133,253,96,0.821296296296,0.600815772444,0.600815772444
3,0,20,0.389121338912,0.871941697033,0.274336283186,0.919824272378,0.321799307958,0.895243185462,339,1821,1675,146,246,93,0.818518518519,0.597080277782,0.597080277782
3,0,21,0.357976653696,0.870204939569,0.271386430678,0.909390444811,0.308724832215,0.889366272825,339,1821,1656,165,247,92,0.809259259259,0.590388437745,0.590388437745
3,0,22,0.368,0.864397905759,0.262108262108,0.912658927584,0.30615640599,0.887873084162,351,1809,1651,158,259,92,0.806944444444,0.587383594846,0.587383594846
3,0,23,0.419087136929,0.868160500261,0.285310734463,0.922480620155,0.339495798319,0.894496644295,354,1806,1666,140,253,101,0.818055555556,0.603895677309,0.603895677309
3,0,24,0.379310344828,0.866182572614,0.254335260116,0.920617420066,0.304498269896,0.892570817745,346,1814,1670,144,258,88,0.813888888889,0.587476340091,0.587476340091
3,0,25,0.402542372881,0.871621621622,0.277777777778,0.922442244224,0.328719723183,0.896312132549,342,1818,1677,141,247,95,0.82037037037,0.600110011001,0.600110011001
3,0,26,0.372294372294,0.867288750648,0.251461988304,0.920242024202,0.30017452007,0.892981051508,342,1818,1673,145,256,86,0.814351851852,0.585852006253,0.585852006253
3,0,27,0.390041493776,0.874413757165,0.280597014925,0.919452054795,0.326388888889,0.896367521368,335,1825,1678,147,241,94,0.82037037037,0.60002453486,0.60002453486
3,0,28,0.382113821138,0.872518286311,0.278106508876,0.916575192097,0.321917808219,0.894004282655,338,1822,1670,152,244,94,0.816666666667,0.597340850486,0.597340850486
3,0,29,0.385650224215,0.868353123387,0.25219941349,0.924683892248,0.304964539007,0.895633652822,341,1819,1682,137,255,86,0.818518518519,0.588441652869,0.588441652869
3,0,30,0.380566801619,0.872451646628,0.278106508876,0.916026344676,0.321367521368,0.893708165997,338,1822,1669,153,244,94,0.816203703704,0.597066426776,0.597066426776
3,0,31,0.381578947368,0.869565217391,0.256637168142,0.922570016474,0.306878306878,0.895283772982,339,1821,1680,141,252,87,0.818055555556,0.589603592308,0.589603592308
3,0,32,0.405286343612,0.866011381273,0.262108262108,0.925373134328,0.318339100346,0.894708711919,351,1809,1674,135,259,92,0.817592592593,0.593740698218,0.593740698218
3,0,33,0.39406779661,0.863305613306,0.261235955056,0.920731707317,0.314189189189,0.891094420601,356,1804,1661,143,263,93,0.812037037037,0.590983831187,0.590983831187
3,0,34,0.404347826087,0.873056994819,0.275147928994,0.924807903403,0.327464788732,0.898187633262,338,1822,1685,137,245,93,0.823148148148,0.599977916198,0.599977916198
3,0,35,0.373333333333,0.868733850129,0.248520710059,0.922612513721,0.298401420959,0.894862922545,338,1822,1681,141,254,84,0.81712962963,0.58556661189,0.58556661189
3,0,36,0.394190871369,0.868681605003,0.273775216138,0.919470490899,0.323129251701,0.893354769561,347,1813,1667,146,252,95,0.815740740741,0.596622853519,0.596622853519
3,0,37,0.410480349345,0.870533402382,0.273255813953,0.925660792952,0.328097731239,0.897251134241,344,1816,1681,135,250,94,0.821759259259,0.599458303453,0.599458303453
3,0,38,0.389121338912,0.870900572618,0.272727272727,0.919736118747,0.320689655172,0.894652406417,341,1819,1673,146,248,93,0.817592592593,0.596231695737,0.596231695737
3,0,39,0.409482758621,0.869294605809,0.273775216138,0.92443463872,0.328151986183,0.896017107725,347,1813,1676,137,252,95,0.819907407407,0.599104927429,0.599104927429
3,0,40,0.381355932203,0.873700623701,0.27027027027,0.92008757526,0.316344463972,0.896294321514,333,1827,1681,146,243,90,0.819907407407,0.595178922765,0.595178922765
3,0,41,0.383259911894,0.867563372995,0.253644314869,0.922949917446,0.305263157895,0.8944,343,1817,1677,140,256,87,0.816666666667,0.588297116158,0.588297116158
3,0,42,0.4,0.8734375,0.283185840708,0.920922570016,0.331606217617,0.896551724138,339,1821,1677,144,243,96,0.820833333333,0.602054205362,0.602054205362
3,0,43,0.396396396396,0.866357069143,0.253602305476,0.926089354661,0.309314586995,0.895227939216,347,1813,1679,134,259,88,0.818055555556,0.589845830068,0.589845830068
3,0,44,0.39837398374,0.871473354232,0.28488372093,0.918502202643,0.332203389831,0.89436997319,344,1816,1668,148,246,98,0.817592592593,0.601692961787,0.601692961787
3,0,45,0.4140969163,0.868598034144,0.270114942529,0.926600441501,0.326956521739,0.896662216288,348,1812,1679,133,254,94,0.820833333333,0.598357692015,0.598357692015
3,0,46,0.387931034483,0.873443983402,0.269461077844,0.922234392114,0.318021201413,0.897176345232,334,1826,1684,142,244,90,0.821296296296,0.595847734979,0.595847734979
3,0,47,0.409090909091,0.86913451512,0.282857142857,0.920994475138,0.334459459459,0.894313304721,350,1810,1667,143,251,99,0.817592592593,0.601925808998,0.601925808998
3,0,48,0.390041493776,0.868160500261,0.270893371758,0.918918918919,0.319727891156,0.89281886388,347,1813,1666,147,253,94,0.814814814815,0.594906145338,0.594906145338
3,0,49,0.394849785408,0.867151011936,0.264367816092,0.922185430464,0.31669535284,0.893821877507,348,1812,1671,141,256,92,0.816203703704,0.593276623278,0.593276623278
3,0,50,0.387931034483,0.866701244813,0.259365994236,0.92167677882,0.310880829016,0.893344025662,347,1813,1671,142,257,90,0.815277777778,0.590521386528,0.590521386528
3,0,51,0.386956521739,0.873056994819,0.266467065868,0.92278203724,0.315602836879,0.897231096912,334,1826,1685,141,245,89,0.821296296296,0.594624551554,0.594624551554
3,0,52,0.395833333333,0.868229166667,0.272988505747,0.919977924945,0.323129251701,0.893354769561,348,1812,1667,145,253,95,0.815740740741,0.596483215346,0.596483215346
3,0,53,0.394422310757,0.87008905186,0.28530259366,0.916161059018,0.33110367893,0.892530897367,347,1813,1661,152,248,99,0.814814814815,0.600731826339,0.600731826339
3,0,54,0.401826484018,0.866563626996,0.253602305476,0.927744070601,0.310954063604,0.896110815131,347,1813,1682,131,259,88,0.819444444444,0.590673188038,0.590673188038
3,0,55,0.399103139013,0.868869385648,0.259475218659,0.926252063841,0.314487632509,0.896643580181,343,1817,1683,134,254,89,0.82037037037,0.59286364125,0.59286364125
3,0,56,0.373949579832,0.871488033299,0.264880952381,0.918311403509,0.310104529617,0.894287239722,336,1824,1675,149,247,89,0.816666666667,0.591596177945,0.591596177945
3,0,57,0.380753138075,0.869859448204,0.266862170088,0.918636613524,0.313793103448,0.893582887701,341,1819,1671,148,250,91,0.815740740741,0.592749391806,0.592749391806
3,0,58,0.395454545455,0.864948453608,0.249283667622,0.926559911651,0.305799648506,0.894694748067,349,1811,1678,133,262,87,0.81712962963,0.587921789636,0.587921789636
3,0,59,0.381147540984,0.872651356994,0.275964391691,0.917169500823,0.320137693632,0.894356779888,337,1823,1672,151,244,93,0.81712962963,0.596566946257,0.596566946257
3,0,60,0.384937238494,0.869859448204,0.269005847953,0.919141914191,0.31669535284,0.893821877507,342,1818,1671,147,250,92,0.816203703704,0.594073881072,0.594073881072
3,0,61,0.406113537118,0.866908337649,0.265714285714,0.924861878453,0.321243523316,0.8949478749,350,1810,1674,136,257,93,0.818055555556,0.595288082084,0.595288082084
3,0,62,0.361788617886,0.87513061651,0.271341463415,0.914301310044,0.310104529617,0.894287239722,328,1832,1675,157,239,89,0.816666666667,0.592821386729,0.592821386729
3,0,63,0.391111111111,0.867700258398,0.255813953488,0.924559471366,0.309314586995,0.895227939216,344,1816,1679,137,256,88,0.818055555556,0.590186712427,0.590186712427
3,0,64,0.383966244726,0.873634945398,0.27245508982,0.92004381161,0.318739054291,0.896238997066,334,1826,1680,146,243,91,0.819907407407,0.596249450715,0.596249450715
3,0,65,0.427947598253,0.872087001554,0.284057971014,0.92782369146,0.341463414634,0.89909236519,345,1815,1684,131,247,98,0.825,0.605940831237,0.605940831237
3,0,66,0.387931034483,0.865145228216,0.257142857143,0.921546961326,0.309278350515,0.892455858748,350,1810,1668,142,260,90,0.813888888889,0.589344909234,0.589344909234
3,0,67,0.39837398374,0.869905956113,0.28242074928,0.918367346939,0.330522765599,0.893480010732,347,1813,1665,148,249,98,0.816203703704,0.600394048109,0.600394048109
3,0,68,0.387931034483,0.866182572614,0.258620689655,0.921633554084,0.310344827586,0.893048128342,348,1812,1670,142,258,90,0.814814814815,0.59012712187,0.59012712187
3,0,69,0.353174603175,0.868448637317,0.261764705882,0.91043956044,0.300675675676,0.888948497854,340,1820,1657,163,251,89,0.808333333333,0.586102133161,0.586102133161
3,0,70,0.371794871795,0.867082035306,0.253644314869,0.919097413319,0.301559792028,0.892332353727,343,1817,1670,147,256,87,0.813425925926,0.586370864094,0.586370864094
3,0,71,0.390476190476,0.865641025641,0.238372093023,0.929515418502,0.296028880866,0.896441848115,344,1816,1688,128,262,82,0.819444444444,0.583943755763,0.583943755763
3,0,72,0.396551724138,0.869813278008,0.268221574344,0.922949917446,0.32,0.895594125501,343,1817,1677,140,251,92,0.818981481481,0.595585745895,0.595585745895
3,0,73,0.391489361702,0.86961038961,0.268221574344,0.921298844249,0.318339100346,0.894708711919,343,1817,1674,143,251,92,0.817592592593,0.594760209296,0.594760209296
3,0,74,0.405982905983,0.870197300104,0.275362318841,0.923415977961,0.328151986183,0.896017107725,345,1815,1676,139,250,95,0.819907407407,0.599389148401,0.599389148401
3,0,75,0.404081632653,0.872584856397,0.288629737609,0.919647771051,0.336734693878,0.895498392283,343,1817,1671,146,244,99,0.819444444444,0.60413875433,0.60413875433
3,0,76,0.390557939914,0.868707836015,0.264534883721,0.921806167401,0.315424610052,0.89446967673,344,1816,1674,142,253,91,0.81712962963,0.593170525561,0.593170525561
3,0,77,0.404347826087,0.863212435233,0.260504201681,0.924015529673,0.316865417376,0.892579694616,357,1803,1666,137,264,93,0.814351851852,0.592259865677,0.592259865677
3,0,78,0.412765957447,0.873766233766,0.285294117647,0.924175824176,0.337391304348,0.89826435247,340,1820,1682,138,243,97,0.823611111111,0.604734970911,0.604734970911
3,0,79,0.397321428571,0.861053719008,0.248603351955,0.925083240844,0.305841924399,0.891920813269,358,1802,1667,135,269,89,0.812962962963,0.586843296399,0.586843296399
3,0,80,0.399122807018,0.865942028986,0.26,0.924309392265,0.314878892734,0.894174238375,350,1810,1673,137,259,91,0.816666666667,0.592154696133,0.592154696133
3,0,81,0.392070484581,0.861872736679,0.25,0.923503325942,0.305317324185,0.891624297565,356,1804,1666,138,267,89,0.8125,0.586751662971,0.586751662971
3,0,82,0.417431192661,0.863542739444,0.255617977528,0.929600886918,0.317073170732,0.895355045382,356,1804,1677,127,265,91,0.818518518519,0.592609432223,0.592609432223
3,0,83,0.368421052632,0.868530020704,0.248520710059,0.92096597146,0.296819787986,0.893979754928,338,1822,1678,144,254,84,0.815740740741,0.58474334076,0.58474334076
3,0,84,0.38864628821,0.86794407043,0.258720930233,0.922907488987,0.310645724258,0.894582332533,344,1816,1676,140,255,89,0.81712962963,0.59081420961,0.59081420961
3,0,85,0.390438247012,0.880565741226,0.300613496933,0.916575790622,0.339688041594,0.898209991985,326,1834,1681,153,228,98,0.823611111111,0.608594643777,0.608594643777
3,0,86,0.400943396226,0.863449691992,0.242165242165,0.929795467109,0.301953818828,0.895395262177,351,1809,1682,127,266,85,0.818055555556,0.585980354637,0.585980354637
3,0,87,0.376569037657,0.86881832379,0.263157894737,0.91804180418,0.309810671256,0.892752072747,342,1818,1669,149,252,90,0.814351851852,0.590599849459,0.590599849459
3,0,88,0.379310344828,0.869813278008,0.259587020649,0.920922570016,0.30823117338,0.894638570285,339,1821,1677,144,251,88,0.81712962963,0.590254795333,0.590254795333
3,0,89,0.371308016878,0.872594903796,0.264264264264,0.918445539135,0.308771929825,0.894933333333,333,1827,1678,149,245,88,0.817592592593,0.5913549017,0.5913549017
3,0,90,0.419913419913,0.869362363919,0.277936962751,0.926007730536,0.334482758621,0.89679144385,349,1811,1677,134,252,97,0.821296296296,0.601972346643,0.601972346643
3,0,91,0.379912663755,0.870533402382,0.258160237389,0.922106417992,0.3074204947,0.89557805008,337,1823,1681,142,250,87,0.818518518519,0.590133327691,0.590133327691
3,0,92,0.388185654008,0.86895475819,0.267441860465,0.920154185022,0.31669535284,0.893821877507,344,1816,1671,145,252,92,0.816203703704,0.593798022744,0.593798022744
3,0,93,0.35593220339,0.872141372141,0.254545454545,0.91693989071,0.296819787986,0.893979754928,330,1830,1678,152,246,84,0.815740740741,0.585742672628,0.585742672628
3,0,94,0.377272727273,0.864432989691,0.239884393064,0.92447629548,0.293286219081,0.893446989877,346,1814,1677,137,263,83,0.814814814815,0.582180344272,0.582180344272
3,0,95,0.398230088496,0.870734229576,0.264705882353,0.925274725275,0.318021201413,0.897176345232,340,1820,1684,136,250,90,0.821296296296,0.594990303814,0.594990303814
3,0,96,0.3875,0.86875,0.269565217391,0.919008264463,0.317948717949,0.893172690763,345,1815,1668,147,252,93,0.815277777778,0.594286740927,0.594286740927
3,0,97,0.387931034483,0.868257261411,0.261627906977,0.921806167401,0.3125,0.894230769231,344,1816,1674,142,254,90,0.816666666667,0.591717037189,0.591717037189
3,0,98,0.392561983471,0.869655891554,0.275362318841,0.919008264463,0.323679727428,0.893651218859,345,1815,1668,147,250,95,0.816203703704,0.597185291652,0.597185291652
3,0,99,0.386266094421,0.868188894655,0.261627906977,0.921255506608,0.311958405546,0.893935345979,344,1816,1673,143,254,90,0.816203703704,0.591441706792,0.591441706792
5,0,0,0.511904761905,0.873493975904,0.254437869822,0.954994511526,0.339920948617,0.912427897221,338,1822,1740,82,252,86,0.84537037037,0.604716190674,0.604716190674
5,0,1,0.50303030303,0.867167919799,0.238505747126,0.954746136865,0.323586744639,0.908852114526,348,1812,1730,82,265,83,0.839351851852,0.596625941996,0.596625941996
5,0,2,0.482954545455,0.871471774194,0.25,0.95,0.329457364341,0.909043112513,340,1820,1729,91,255,85,0.839814814815,0.6,0.6
5,0,3,0.488888888889,0.864141414141,0.24649859944,0.948973932335,0.327746741155,0.90457309014,357,1803,1711,92,269,88,0.83287037037,0.597736265887,0.597736265887
5,0,4,0.491228070175,0.871794871795,0.247787610619,0.952224052718,0.329411764706,0.910236220472,339,1821,1734,87,255,84,0.841666666667,0.600005831669,0.600005831669
5,0,5,0.468926553672,0.874432677761,0.25,0.948577680525,0.326129666012,0.909997376017,332,1828,1734,94,249,83,0.841203703704,0.599288840263,0.599288840263
5,0,6,0.446927374302,0.86925795053,0.23598820059,0.945634266886,0.30888030888,0.905839032088,339,1821,1722,99,259,80,0.834259259259,0.590811233738,0.590811233738
5,0,7,0.453488372093,0.863682092555,0.223495702006,0.948094975152,0.299424184261,0.903922084759,349,1811,1717,94,271,78,0.831018518519,0.585795338579,0.585795338579
5,0,8,0.5,0.870463709677,0.255072463768,0.951515151515,0.337811900192,0.90918662806,345,1815,1727,88,257,88,0.840277777778,0.603293807642,0.603293807642
5,0,9,0.496932515337,0.868803204807,0.236151603499,0.954870665933,0.320158102767,0.909805977976,343,1817,1735,82,262,81,0.840740740741,0.595511134716,0.595511134716
5,0,10,0.51497005988,0.868539889614,0.247126436782,0.955298013245,0.333980582524,0.909855453351,348,1812,1731,81,262,86,0.841203703704,0.601212225013,0.601212225013
5,0,11,0.48,0.865491183879,0.239316239316,0.949695964621,0.319391634981,0.905640484976,351,1809,1718,91,267,84,0.834259259259,0.594506101969,0.594506101969
5,0,12,0.491124260355,0.867403314917,0.239193083573,0.952564809708,0.321705426357,0.907991587802,347,1813,1727,86,264,83,0.837962962963,0.595878946641,0.595878946641
5,0,13,0.475935828877,0.868727825646,0.255747126437,0.94591611479,0.332710280374,0.905680317041,348,1812,1714,98,259,89,0.834722222222,0.600831620614,0.600831620614
5,0,14,0.485549132948,0.871665827881,0.247787610619,0.95112575508,0.328125,0.909663865546,339,1821,1732,89,255,84,0.840740740741,0.59945668285,0.59945668285
5,0,15,0.496815286624,0.870194707938,0.230769230769,0.956641053787,0.315151515152,0.91137254902,338,1822,1743,79,260,78,0.843055555556,0.593705142278,0.593705142278
5,0,16,0.497237569061,0.874684183931,0.266272189349,0.950054884742,0.346820809249,0.910812943962,338,1822,1731,91,248,90,0.843055555556,0.608163537046,0.608163537046
5,0,17,0.48087431694,0.874557410218,0.261904761905,0.947916666667,0.339113680154,0.909760589319,336,1824,1729,95,248,88,0.841203703704,0.604910714286,0.604910714286
5,0,18,0.468571428571,0.872544080605,0.244776119403,0.94904109589,0.321568627451,0.909186351706,335,1825,1732,93,253,82,0.839814814815,0.596908607647,0.596908607647
5,0,19,0.46408839779,0.870136432542,0.24633431085,0.946673996701,0.32183908046,0.906793048973,341,1819,1722,97,257,84,0.836111111111,0.596504153776,0.596504153776
5,0,20,0.505882352941,0.865829145729,0.243626062323,0.953514111787,0.328871892925,0.907558598894,353,1807,1723,84,267,86,0.8375,0.598570087055,0.598570087055
5,0,21,0.521739130435,0.869434717359,0.24347826087,0.957575757576,0.332015810277,0.911379129523,345,1815,1738,77,261,84,0.843518518519,0.600527009223,0.600527009223
5,0,22,0.459016393443,0.867475973698,0.242774566474,0.945424476295,0.317580340265,0.90477446584,346,1814,1715,99,262,84,0.83287037037,0.594099521385,0.594099521385
5,0,23,0.47619047619,0.868975903614,0.234604105572,0.951621770203,0.314341846758,0.908422986093,341,1819,1731,88,261,80,0.838425925926,0.593112937888,0.593112937888
5,0,24,0.467455621302,0.8694123556,0.233038348083,0.95057660626,0.311023622047,0.908184679958,339,1821,1731,90,260,79,0.837962962963,0.591807477171,0.591807477171
5,0,25,0.477528089888,0.871342078708,0.25,0.948901098901,0.328185328185,0.908469226723,340,1820,1727,93,255,85,0.838888888889,0.599450549451,0.599450549451
5,0,26,0.477272727273,0.866935483871,0.241379310345,0.949227373068,0.320610687023,0.906217070601,348,1812,1720,92,264,84,0.835185185185,0.595303341707,0.595303341707
5,0,27,0.505813953488,0.876257545272,0.261261261261,0.953475643131,0.344554455446,0.913237221494,333,1827,1742,85,246,87,0.846759259259,0.607368452196,0.607368452196
5,0,28,0.503144654088,0.864567716142,0.22792022792,0.956329463792,0.313725490196,0.90813648294,351,1809,1730,79,271,80,0.837962962963,0.592124845856,0.592124845856
5,0,29,0.462427745665,0.867136386512,0.232558139535,0.948788546256,0.309477756286,0.906126742046,344,1816,1723,93,264,80,0.834722222222,0.590673342895,0.590673342895
5,0,30,0.556886227545,0.875062719518,0.271929824561,0.959295929593,0.365422396857,0.91524534243,342,1818,1744,74,249,93,0.850462962963,0.615612877077,0.615612877077
5,0,31,0.44,0.871536523929,0.231927710843,0.946389496718,0.303747534517,0.907421977446,332,1828,1730,98,255,77,0.836574074074,0.589158603781,0.589158603781
5,0,32,0.488888888889,0.874747474747,0.261904761905,0.949561403509,0.341085271318,0.910620399579,336,1824,1732,92,248,88,0.842592592593,0.605733082707,0.605733082707
5,0,33,0.477528089888,0.870332996973,0.248538011696,0.948844884488,0.326923076923,0.907894736842,342,1818,1725,93,257,85,0.837962962963,0.598691448092,0.598691448092
5,0,34,0.508670520231,0.868142929039,0.251428571429,0.953038674033,0.336520076482,0.908612062154,350,1810,1725,85,262,88,0.839351851852,0.602233622731,0.602233622731
5,0,35,0.485549132948,0.870659285355,0.24633431085,0.951072017592,0.326848249027,0.909090909091,341,1819,1730,89,257,84,0.839814814815,0.598703164221,0.598703164221
5,0,36,0.5,0.866801210898,0.252124645892,0.950747094632,0.335216572505,0.906835576669,353,1807,1718,89,264,89,0.836574074074,0.601435870262,0.601435870262
5,0,37,0.497041420118,0.869914615771,0.244897959184,0.953219592735,0.328125,0.909663865546,343,1817,1732,85,259,84,0.840740740741,0.599058775959,0.599058775959
5,0,38,0.488235294118,0.871859296482,0.245562130178,0.952250274424,0.326771653543,0.910283315845,338,1822,1735,87,255,83,0.841666666667,0.598906202301,0.598906202301
5,0,39,0.482954545455,0.869959677419,0.247813411079,0.94991744634,0.327552986513,0.908182057353,343,1817,1726,91,258,85,0.838425925926,0.598865428709,0.598865428709
5,0,40,0.488888888889,0.872727272727,0.258823529412,0.949450549451,0.338461538462,0.909473684211,340,1820,1728,92,252,88,0.840740740741,0.604137039431,0.604137039431
5,0,41,0.48,0.873047858942,0.25,0.950109649123,0.328767123288,0.909950118141,336,1824,1733,91,252,84,0.841203703704,0.600054824561,0.600054824561
5,0,42,0.483333333333,0.872222222222,0.255882352941,0.948901098901,0.334615384615,0.908947368421,340,1820,1727,93,253,87,0.839814814815,0.602391725921,0.602391725921
5,0,43,0.538961038961,0.86889332004,0.239884393064,0.960859977949,0.332,0.912565445026,346,1814,1743,71,263,83,0.84537037037,0.600372185506,0.600372185506
5,0,44,0.482954545455,0.869455645161,0.247093023256,0.949889867841,0.326923076923,0.907894736842,344,1816,1725,91,259,85,0.837962962963,0.598491445549,0.598491445549
5,0,45,0.474576271186,0.871406959153,0.247787610619,0.948929159802,0.325581395349,0.908517350158,339,1821,1728,93,255,84,0.838888888889,0.598358385211,0.598358385211
5,0,46,0.527607361963,0.871306960441,0.250728862974,0.957622454595,0.339920948617,0.912427897221,343,1817,1740,77,257,86,0.84537037037,0.604175658785,0.604175658785
5,0,47,0.459459459459,0.871392405063,0.250737463127,0.945085118067,0.324427480916,0.906743940991,339,1821,1721,100,254,85,0.836111111111,0.597911290597,0.597911290597
5,0,48,0.51724137931,0.87361530715,0.263929618768,0.953820780649,0.349514563107,0.911957950066,341,1819,1735,84,251,90,0.844907407407,0.608875199709,0.608875199709
5,0,49,0.472527472527,0.872598584429,0.254437869822,0.94731064764,0.330769230769,0.908421052632,338,1822,1726,96,252,86,0.838888888889,0.600874258731,0.600874258731
5,0,50,0.485714285714,0.875062972292,0.255255255255,0.950738916256,0.334645669291,0.911332633788,333,1827,1737,90,248,85,0.843518518519,0.602997085756,0.602997085756
5,0,51,0.505952380952,0.870983935743,0.248538011696,0.954345434543,0.333333333333,0.910761154856,342,1818,1735,83,257,85,0.842592592593,0.60144172312,0.60144172312
5,0,52,0.512820512821,0.869760479042,0.234604105572,0.958218801539,0.321931589537,0.911849332985,341,1819,1743,76,261,80,0.843981481481,0.596411453556,0.596411453556
5,0,53,0.505813953488,0.869718309859,0.251445086705,0.953142227122,0.335907335907,0.909521304577,346,1814,1729,85,259,87,0.840740740741,0.602293656914,0.602293656914
5,0,54,0.517647058824,0.869346733668,0.252873563218,0.954746136865,0.339768339768,0.910047343503,348,1812,1730,82,260,88,0.841666666667,0.603809850042,0.603809850042
5,0,55,0.48087431694,0.872028325746,0.258064516129,0.947773501924,0.335877862595,0.90832455216,341,1819,1724,95,253,88,0.838888888889,0.602919009027,0.602919009027
5,0,56,0.479532163743,0.867772750126,0.23768115942,0.950964187328,0.317829457364,0.907465825447,345,1815,1726,89,263,82,0.837037037037,0.594322673374,0.594322673374
5,0,57,0.527272727273,0.869172932331,0.25,0.956953642384,0.33918128655,0.910953506698,348,1812,1734,78,261,87,0.843055555556,0.603476821192,0.603476821192
5,0,58,0.465517241379,0.870594159114,0.239644970414,0.948957189901,0.31640625,0.908088235294,338,1822,1729,93,257,81,0.837962962963,0.594301080158,0.594301080158
5,0,59,0.5,0.86372745491,0.231638418079,0.954595791805,0.316602316602,0.906891109942,354,1806,1724,82,272,82,0.836111111111,0.593117104942,0.593117104942
5,0,60,0.509202453988,0.8668002003,0.23782234957,0.955825510768,0.32421875,0.909138655462,349,1811,1731,80,266,83,0.839814814815,0.596823930169,0.596823930169
5,0,61,0.485714285714,0.874055415617,0.253731343284,0.950684931507,0.333333333333,0.910761154856,335,1825,1735,90,250,85,0.842592592593,0.602208137395,0.602208137395
5,0,62,0.48,0.869521410579,0.244897959184,0.94991744634,0.324324324324,0.907943187796,343,1817,1726,91,259,84,0.837962962963,0.597407702762,0.597407702762
5,0,63,0.461956521739,0.869939271255,0.248538011696,0.945544554455,0.32319391635,0.906167633105,342,1818,1719,99,257,85,0.835185185185,0.597041283076,0.597041283076
5,0,64,0.502824858757,0.870398386283,0.257225433526,0.951488423374,0.34034416826,0.909138793785,346,1814,1726,88,257,89,0.840277777778,0.60435692845,0.60435692845
5,0,65,0.452941176471,0.865326633166,0.223188405797,0.948760330579,0.299029126214,0.905124835742,345,1815,1722,93,268,77,0.83287037037,0.585974368188,0.585974368188
5,0,66,0.465909090909,0.867943548387,0.238372093023,0.948237885463,0.315384615385,0.906315789474,344,1816,1722,94,262,82,0.835185185185,0.593304989243,0.593304989243
5,0,67,0.480225988701,0.868381240545,0.245664739884,0.949283351709,0.325047801147,0.907031867264,346,1814,1722,92,261,85,0.836574074074,0.597474045797,0.597474045797
5,0,68,0.5,0.869346733668,0.246376811594,0.953168044077,0.330097087379,0.909329829172,345,1815,1730,85,260,85,0.840277777778,0.599772427836,0.599772427836
5,0,69,0.514285714286,0.869521410579,0.25787965616,0.953064605191,0.343511450382,0.90937829294,349,1811,1726,85,259,90,0.840740740741,0.605472130675,0.605472130675
5,0,70,0.5,0.872222222222,0.262390670554,0.950467804073,0.344168260038,0.909665525415,343,1817,1727,90,253,90,0.841203703704,0.606429237313,0.606429237313
5,0,71,0.534591194969,0.863568215892,0.237430167598,0.958934517203,0.328820116054,0.90875624507,358,1802,1728,74,273,85,0.839351851852,0.5981823424,0.5981823424
5,0,72,0.512195121951,0.867735470942,0.241379310345,0.955849889625,0.328125,0.909663865546,348,1812,1732,80,264,84,0.840740740741,0.598614599985,0.598614599985
5,0,73,0.464285714286,0.866967871486,0.227405247813,0.950467804073,0.305283757339,0.906799684957,343,1817,1727,90,265,78,0.835648148148,0.588936525943,0.588936525943
5,0,74,0.506024096386,0.872116349047,0.247787610619,0.954969796815,0.332673267327,0.911664482307,339,1821,1739,82,255,84,0.843981481481,0.601378703717,0.601378703717
5,0,75,0.478787878788,0.867167919799,0.229651162791,0.952643171806,0.310412573674,0.907898189452,344,1816,1730,86,265,79,0.8375,0.591147167298,0.591147167298
5,0,76,0.5,0.871963562753,0.266666666667,0.949311294766,0.347826086957,0.90899498813,345,1815,1723,92,253,92,0.840277777778,0.607988980716,0.607988980716
5,0,77,0.497142857143,0.869017632242,0.250720461095,0.951461665747,0.333333333333,0.908372827804,347,1813,1725,88,260,87,0.838888888889,0.601091063421,0.601091063421
5,0,78,0.508771929825,0.867269984917,0.247863247863,0.953565505804,0.333333333333,0.908372827804,351,1809,1725,84,264,87,0.838888888889,0.600714376834,0.600714376834
5,0,79,0.511494252874,0.875629405841,0.264880952381,0.953399122807,0.349019607843,0.912860892388,336,1824,1739,85,247,89,0.846296296296,0.609140037594,0.609140037594
5,0,80,0.467065868263,0.869543401907,0.230769230769,0.951152579583,0.308910891089,0.908519003932,338,1822,1733,89,260,78,0.838425925926,0.590960905176,0.590960905176
5,0,81,0.485380116959,0.871794871795,0.245562130178,0.951701427003,0.326129666012,0.909997376017,338,1822,1734,88,255,83,0.841203703704,0.59863177859,0.59863177859
5,0,82,0.5,0.867265469062,0.226744186047,0.95704845815,0.312,0.909947643979,344,1816,1738,78,266,78,0.840740740741,0.591896322098,0.591896322098
5,0,83,0.521739130435,0.866433216608,0.239316239316,0.957435046987,0.328125,0.909663865546,351,1809,1732,77,267,84,0.840740740741,0.598375643152,0.598375643152
5,0,84,0.506024096386,0.869608826479,0.244186046512,0.954845814978,0.329411764706,0.910236220472,344,1816,1734,82,260,84,0.841666666667,0.599515930745,0.599515930745
5,0,85,0.50289017341,0.873678912934,0.257396449704,0.952799121844,0.340508806262,0.911525334734,338,1822,1736,86,251,87,0.843981481481,0.605097785774,0.605097785774
5,0,86,0.519736842105,0.864043824701,0.224431818182,0.959623893805,0.313492063492,0.909329140461,352,1808,1735,73,273,79,0.839814814815,0.592027855994,0.592027855994
5,0,87,0.508982035928,0.870045158053,0.247093023256,0.954845814978,0.332681017613,0.910475190339,344,1816,1734,82,259,85,0.84212962963,0.600969419117,0.600969419117
5,0,88,0.505617977528,0.873864783047,0.264705882353,0.951648351648,0.34749034749,0.911099421357,340,1820,1732,88,250,90,0.843518518519,0.608177117001,0.608177117001
5,0,89,0.469613259669,0.872157655382,0.251479289941,0.94731064764,0.327552986513,0.908182057353,338,1822,1726,96,253,85,0.838425925926,0.59939496879,0.59939496879
5,0,90,0.50303030303,0.871177944862,0.244117647059,0.954945054945,0.328712871287,0.911140235911,340,1820,1738,82,257,83,0.843055555556,0.599531351002,0.599531351002
5,0,91,0.508875739645,0.868407835259,0.247126436782,0.954194260486,0.332688588008,0.909282145674,348,1812,1729,83,262,86,0.840277777778,0.600660348634,0.600660348634
5,0,92,0.488372093023,0.871730382294,0.247787610619,0.951674903899,0.328767123288,0.909950118141,339,1821,1733,88,255,84,0.841203703704,0.599731257259,0.599731257259
5,0,93,0.487804878049,0.870240480962,0.23598820059,0.953871499176,0.318091451292,0.910138852502,339,1821,1737,84,259,80,0.841203703704,0.594929849883,0.594929849883
5,0,94,0.497142857143,0.872040302267,0.255131964809,0.951621770203,0.337209302326,0.910094637224,341,1819,1731,88,254,87,0.841666666667,0.603376867506,0.603376867506
5,0,95,0.46783625731,0.867772750126,0.233236151603,0.94991744634,0.311284046693,0.906988964792,343,1817,1726,91,263,80,0.836111111111,0.591576798972,0.591576798972
5,0,96,0.477011494253,0.875125881168,0.250755287009,0.950246036085,0.328712871287,0.911140235911,331,1829,1738,91,248,83,0.843055555556,0.600500661547,0.600500661547
5,0,97,0.441717791411,0.868803204807,0.215568862275,0.950164293538,0.289738430584,0.907664138111,334,1826,1735,91,262,72,0.836574074074,0.582866577907,0.582866577907
5,0,98,0.45652173913,0.875506072874,0.254545454545,0.945355191257,0.326848249027,0.909090909091,330,1830,1730,100,246,84,0.839814814815,0.599950322901,0.599950322901
5,0,99,0.473988439306,0.872672370408,0.244776119403,0.950136986301,0.322834645669,0.909758656873,335,1825,1734,91,253,82,0.840740740741,0.597456552852,0.597456552852
7,0,0,0.554744525547,0.869500741473,0.223529411765,0.966483516484,0.318658280922,0.915430653136,340,1820,1759,61,264,76,0.849537037037,0.595006464124,0.595006464124
7,0,1,0.551020408163,0.868852459016,0.234782608696,0.963636363636,0.329268292683,0.913793103448,345,1815,1749,66,264,81,0.847222222222,0.599209486166,0.599209486166
7,0,2,0.537313432836,0.867226061204,0.211143695015,0.965915338098,0.303157894737,0.913914174252,341,1819,1757,62,269,72,0.846759259259,0.588529516556,0.588529516556
7,0,3,0.554794520548,0.868917576961,0.234782608696,0.964187327824,0.329938900204,0.91407678245,345,1815,1750,65,264,81,0.847685185185,0.59948496826,0.59948496826
7,0,4,0.571428571429,0.865781710914,0.208695652174,0.970247933884,0.305732484076,0.915042868277,345,1815,1761,54,273,72,0.848611111111,0.589471793029,0.589471793029
7,0,5,0.584,0.859950859951,0.203910614525,0.971143174251,0.302277432712,0.912170966901,358,1802,1750,52,285,73,0.843981481481,0.587526894388,0.587526894388
7,0,6,0.565217391304,0.871909000989,0.231454005935,0.96708721887,0.328421052632,0.917035110533,337,1823,1763,60,259,78,0.852314814815,0.599270612402,0.599270612402
7,0,7,0.496402877698,0.865907966353,0.202941176471,0.961538461538,0.288100208768,0.911221036188,340,1820,1750,70,271,69,0.84212962963,0.582239819005,0.582239819005
7,0,8,0.545454545455,0.86932938856,0.213649851632,0.96708721887,0.307036247335,0.915606336017,337,1823,1763,60,265,72,0.849537037037,0.590368535251,0.590368535251
7,0,9,0.536231884058,0.86943620178,0.218934911243,0.964873765093,0.310924369748,0.914672216441,338,1822,1758,64,264,74,0.848148148148,0.591904338168,0.591904338168
7,0,10,0.583333333333,0.87003968254,0.242774566474,0.966923925028,0.342857142857,0.91592689295,346,1814,1754,60,262,84,0.850925925926,0.604849245751,0.604849245751
7,0,11,0.524390243902,0.872745490982,0.252941176471,0.957142857143,0.34126984127,0.912997903564,340,1820,1742,78,254,86,0.846296296296,0.605042016807,0.605042016807
7,0,12,0.549295774648,0.868681863231,0.227405247813,0.964777105118,0.321649484536,0.914211212516,343,1817,1753,64,265,78,0.847685185185,0.596091176466,0.596091176466
7,0,13,0.521428571429,0.871782178218,0.219879518072,0.963347921225,0.309322033898,0.915280665281,332,1828,1761,67,259,73,0.849074074074,0.591613719649,0.591613719649
7,0,14,0.55303030303,0.867357001972,0.213450292398,0.967546754675,0.308016877637,0.914716588664,342,1818,1759,59,269,73,0.848148148148,0.590498523537,0.590498523537
7,0,15,0.517730496454,0.870232788509,0.217910447761,0.962739726027,0.306722689076,0.914151925078,335,1825,1757,68,262,73,0.847222222222,0.590325086894,0.590325086894
7,0,16,0.528169014085,0.86521308226,0.21613832853,0.96304467733,0.306748466258,0.911511354738,347,1813,1746,67,272,75,0.843055555556,0.58959150293,0.58959150293
7,0,17,0.533333333333,0.867164179104,0.230547550432,0.96138996139,0.321931589537,0.911849332985,347,1813,1743,70,267,80,0.843981481481,0.595968755911,0.595968755911
7,0,18,0.585714285714,0.868811881188,0.236311239193,0.968008825152,0.336755646817,0.915731802765,347,1813,1755,58,265,82,0.850462962963,0.602160032172,0.602160032172
7,0,19,0.530201342282,0.87071108901,0.233038348083,0.961559582647,0.323770491803,0.91388308977,339,1821,1751,70,260,79,0.847222222222,0.597298965365,0.597298965365
7,0,20,0.540740740741,0.865185185185,0.21098265896,0.965821389195,0.303534303534,0.912737692107,346,1814,1752,62,273,73,0.844907407407,0.588402024077,0.588402024077
7,0,21,0.557823129252,0.872826626925,0.242603550296,0.964324917673,0.338144329897,0.91629726206,338,1822,1757,65,256,82,0.851388888889,0.603464233984,0.603464233984
7,0,22,0.510638297872,0.866270430906,0.210526315789,0.96204620462,0.298136645963,0.911649726349,342,1818,1749,69,270,72,0.843055555556,0.586286260205,0.586286260205
7,0,23,0.534722222222,0.86755952381,0.223837209302,0.963105726872,0.315573770492,0.912839248434,344,1816,1749,67,267,77,0.84537037037,0.593471468087,0.593471468087
7,0,24,0.517730496454,0.87171867261,0.219879518072,0.962800875274,0.30866807611,0.914998700286,332,1828,1760,68,259,73,0.848611111111,0.591340196673,0.591340196673
7,0,25,0.590909090909,0.86291913215,0.219101123596,0.970066518847,0.319672131148,0.913361169102,356,1804,1750,54,278,78,0.846296296296,0.594583821221,0.594583821221
7,0,26,0.535211267606,0.865708622398,0.219020172911,0.963596249311,0.310838445808,0.912033411642,347,1813,1747,66,271,76,0.843981481481,0.591308211111,0.591308211111
7,0,27,0.554794520548,0.866931479643,0.232091690544,0.964108227499,0.327272727273,0.912941176471,349,1811,1746,65,268,81,0.845833333333,0.598099959022,0.598099959022
7,0,28,0.612403100775,0.869030034466,0.228985507246,0.972451790634,0.333333333333,0.917836713469,345,1815,1765,50,266,79,0.853703703704,0.60071864894,0.60071864894
7,0,29,0.478873239437,0.86917740337,0.204819277108,0.959518599562,0.286919831224,0.912116484659,332,1828,1754,74,264,68,0.843518518519,0.582168938335,0.582168938335
7,0,30,0.592307692308,0.863054187192,0.216901408451,0.970637119114,0.317525773196,0.91368970013,355,1805,1752,53,278,77,0.846759259259,0.593769263782,0.593769263782
7,0,31,0.525179856115,0.866402770905,0.212827988338,0.963676389653,0.302904564315,0.912454403335,343,1817,1751,66,270,73,0.844444444444,0.588252188996,0.588252188996
7,0,32,0.551470588235,0.864130434783,0.214285714286,0.966298342541,0.308641975309,0.912363067293,350,1810,1749,61,275,75,0.844444444444,0.590292028414,0.590292028414
7,0,33,0.586956521739,0.867457962413,0.232091690544,0.968525676422,0.332648870637,0.915210018262,349,1811,1754,57,268,81,0.849537037037,0.600308683483,0.600308683483
7,0,34,0.540540540541,0.869781312127,0.233918128655,0.962596259626,0.326530612245,0.913838120104,342,1818,1750,68,262,80,0.847222222222,0.59825719414,0.59825719414
7,0,35,0.55,0.868811881188,0.22514619883,0.965346534653,0.319502074689,0.914538822303,342,1818,1755,63,265,77,0.848148148148,0.595246366742,0.595246366742
7,0,36,0.557251908397,0.865450961065,0.21098265896,0.96802646086,0.30607966457,0.913869372886,346,1814,1756,58,273,73,0.846759259259,0.58950455991,0.58950455991
7,0,37,0.538461538462,0.866995073892,0.205882352941,0.967032967033,0.297872340426,0.914285714286,340,1820,1760,60,270,70,0.847222222222,0.586457659987,0.586457659987
7,0,38,0.51048951049,0.86812097174,0.215339233038,0.961559582647,0.302904564315,0.912454403335,339,1821,1751,70,266,73,0.844444444444,0.588449407843,0.588449407843
7,0,39,0.601449275362,0.870425321464,0.240579710145,0.969696969697,0.343685300207,0.917383372426,345,1815,1760,55,262,83,0.853240740741,0.605138339921,0.605138339921
7,0,40,0.550387596899,0.867552929591,0.208823529412,0.968131868132,0.302771855011,0.915086990392,340,1820,1762,58,269,71,0.848611111111,0.588477698772,0.588477698772
7,0,41,0.558441558442,0.869890329013,0.247838616715,0.96249310535,0.343313373253,0.913851793663,347,1813,1745,68,261,86,0.847685185185,0.605165861032,0.605165861032
7,0,42,0.529850746269,0.868706811451,0.210682492582,0.965441579813,0.301486199575,0.914523252793,337,1823,1760,63,266,71,0.847685185185,0.588062036198,0.588062036198
7,0,43,0.577777777778,0.864197530864,0.220963172805,0.968456004427,0.319672131148,0.913361169102,353,1807,1750,57,275,78,0.846296296296,0.594709588616,0.594709588616
7,0,44,0.546153846154,0.869458128079,0.21130952381,0.967653508772,0.304721030043,0.915931499741,336,1824,1765,59,265,71,0.85,0.589481516291,0.589481516291
7,0,45,0.573770491803,0.86310107949,0.200573065903,0.971286581999,0.297239915074,0.914003637308,349,1811,1759,52,279,70,0.846759259259,0.585929823951,0.585929823951
7,0,46,0.503311258278,0.872573419612,0.228915662651,0.958971553611,0.314699792961,0.913734688559,332,1828,1753,75,256,76,0.846759259259,0.593943608131,0.593943608131
7,0,47,0.557046979866,0.865738438588,0.235127478754,0.963475373547,0.330677290837,0.911995809324,353,1807,1741,66,270,83,0.844444444444,0.59930142615,0.59930142615
7,0,48,0.558139534884,0.865091088134,0.208092485549,0.968577728776,0.303157894737,0.913914174252,346,1814,1757,57,274,72,0.846759259259,0.588335107163,0.588335107163
7,0,49,0.518248175182,0.870489372219,0.213213213213,0.963875205255,0.302127659574,0.914805194805,333,1827,1761,66,262,71,0.848148148148,0.588544209234,0.588544209234
7,0,50,0.531468531469,0.867129400099,0.220930232558,0.963105726872,0.312114989733,0.912601095747,344,1816,1749,67,268,76,0.844907407407,0.592017979715,0.592017979715
7,0,51,0.544715447154,0.868433971527,0.2,0.969315068493,0.292576419214,0.916105644744,335,1825,1769,56,268,67,0.85,0.584657534247,0.584657534247
7,0,52,0.561538461538,0.86354679803,0.208571428571,0.968508287293,0.304166666667,0.913020833333,350,1810,1753,57,277,73,0.84537037037,0.588539857932,0.588539857932
7,0,53,0.507246376812,0.865479723046,0.204678362573,0.962596259626,0.291666666667,0.911458333333,342,1818,1750,68,272,70,0.842592592593,0.5836373111,0.5836373111
7,0,54,0.561151079137,0.873330034636,0.233532934132,0.966593647317,0.329809725159,0.917598128412,334,1826,1765,61,256,78,0.853240740741,0.600063290724,0.600063290724
7,0,55,0.586776859504,0.866601275135,0.206997084548,0.972482113374,0.306034482759,0.916493775934,343,1817,1767,50,272,71,0.850925925926,0.589739598961,0.589739598961
7,0,56,0.574626865672,0.869200394867,0.22514619883,0.968646864686,0.323529411765,0.916233090531,342,1818,1761,57,265,77,0.850925925926,0.596896531758,0.596896531758
7,0,57,0.521428571429,0.866336633663,0.212827988338,0.963126031921,0.302277432712,0.912170966901,343,1817,1750,67,270,73,0.843981481481,0.587977010129,0.587977010129
7,0,58,0.531468531469,0.869112543381,0.223529411765,0.963186813187,0.314699792961,0.913734688559,340,1820,1753,67,264,76,0.846759259259,0.593358112476,0.593358112476
7,0,59,0.546762589928,0.867887184562,0.221574344023,0.965327462851,0.315352697095,0.914017717561,343,1817,1754,63,267,76,0.847222222222,0.593450903437,0.593450903437
7,0,60,0.554744525547,0.863074641621,0.215297450425,0.966242390703,0.310204081633,0.911749347258,353,1807,1746,61,277,76,0.843518518519,0.590769920564,0.590769920564
7,0,61,0.527559055118,0.866207575012,0.197640117994,0.96705107084,0.287553648069,0.913855734302,339,1821,1761,60,272,67,0.846296296296,0.582345594417,0.582345594417
7,0,62,0.544217687075,0.870342771982,0.234604105572,0.963166575041,0.327868852459,0.914405010438,341,1819,1752,67,261,80,0.848148148148,0.598885340307,0.598885340307
7,0,63,0.544217687075,0.867362146051,0.230547550432,0.96304467733,0.323886639676,0.912702561422,347,1813,1746,67,267,80,0.84537037037,0.596796113881,0.596796113881
7,0,64,0.56462585034,0.871336313959,0.24269005848,0.964796479648,0.339468302658,0.915687809971,342,1818,1754,64,259,83,0.850462962963,0.603743269064,0.603743269064
7,0,65,0.577777777778,0.875555555556,0.236363636364,0.968852459016,0.335483870968,0.919844357977,330,1830,1773,57,252,78,0.856944444444,0.60260804769,0.60260804769
7,0,66,0.590909090909,0.866370808679,0.223495702006,0.970182219768,0.324324324324,0.915342537119,349,1811,1757,54,271,78,0.849537037037,0.596838960887,0.596838960887
7,0,67,0.53488372093,0.871491875923,0.209090909091,0.967213114754,0.300653594771,0.916860916861,330,1830,1770,60,261,69,0.851388888889,0.588152011923,0.588152011923
7,0,68,0.521428571429,0.870792079208,0.218562874251,0.963307776561,0.308016877637,0.914716588664,334,1826,1759,67,261,73,0.848148148148,0.590935325406,0.590935325406
7,0,69,0.523076923077,0.866502463054,0.200589970501,0.965952773202,0.289978678038,0.913528953519,339,1821,1759,62,271,68,0.845833333333,0.583271371852,0.583271371852
7,0,70,0.576642335766,0.864063272368,0.223163841808,0.96788482835,0.321792260692,0.91303212327,354,1806,1748,58,275,79,0.845833333333,0.595524335079,0.595524335079
7,0,71,0.539682539683,0.862340216323,0.195402298851,0.967991169978,0.286919831224,0.912116484659,348,1812,1754,58,280,68,0.843518518519,0.581696734414,0.581696734414
7,0,72,0.59375,0.863188976378,0.214689265537,0.971207087486,0.315352697095,0.914017717561,354,1806,1754,52,278,76,0.847222222222,0.592948176511,0.592948176511
7,0,73,0.544776119403,0.864758144126,0.210374639769,0.966354109211,0.303534303534,0.912737692107,347,1813,1752,61,274,73,0.844907407407,0.58836437449,0.58836437449
7,0,74,0.549618320611,0.862000985707,0.204545454545,0.967367256637,0.298136645963,0.911649726349,352,1808,1749,59,280,72,0.843055555556,0.585956355591,0.585956355591
7,0,75,0.525925925926,0.867160493827,0.208823529412,0.964835164835,0.298947368421,0.913394018205,340,1820,1756,64,269,71,0.845833333333,0.586829347123,0.586829347123
7,0,76,0.533333333333,0.866172839506,0.209912536443,0.965327462851,0.301255230126,0.9130661114,343,1817,1754,63,271,72,0.84537037037,0.587619999647,0.587619999647
7,0,77,0.540740740741,0.868148148148,0.214705882353,0.965934065934,0.307368421053,0.914434330299,340,1820,1758,62,267,73,0.847685185185,0.590319974144,0.590319974144
7,0,78,0.552447552448,0.870599900843,0.232352941176,0.964835164835,0.327122153209,0.915298410216,340,1820,1756,64,261,79,0.849537037037,0.598594053006,0.598594053006
7,0,79,0.589147286822,0.868045297883,0.220930232558,0.970814977974,0.321353065539,0.916558357161,344,1816,1763,53,268,76,0.851388888889,0.595872605266,0.595872605266
7,0,80,0.543307086614,0.858829316281,0.193820224719,0.967849223947,0.285714285714,0.910086004691,356,1804,1746,58,287,69,0.840277777778,0.580834724333,0.580834724333
7,0,81,0.537878787879,0.868836291913,0.210682492582,0.966538672518,0.302771855011,0.915086990392,337,1823,1762,61,266,71,0.848611111111,0.58861058255,0.58861058255
7,0,82,0.553191489362,0.860822189203,0.217270194986,0.965019433648,0.312,0.909947643979,359,1801,1738,63,281,78,0.840740740741,0.591144814317,0.591144814317
7,0,83,0.557251908397,0.86643666831,0.212209302326,0.968061674009,0.307368421053,0.914434330299,344,1816,1758,58,271,73,0.847685185185,0.590135488167,0.590135488167
7,0,84,0.526315789474,0.86433152442,0.202898550725,0.965289256198,0.292887029289,0.912024986986,345,1815,1752,63,275,70,0.843518518519,0.584093903461,0.584093903461
7,0,85,0.569343065693,0.8690064261,0.227405247813,0.967528893781,0.325,0.915625,343,1817,1758,59,265,78,0.85,0.597467070797,0.597467070797
7,0,86,0.528571428571,0.866831683168,0.215743440233,0.963676389653,0.306418219462,0.912692207454,343,1817,1751,66,269,74,0.844907407407,0.589709914943,0.589709914943
7,0,87,0.593984962406,0.86827824371,0.228323699422,0.970231532525,0.329853862213,0.916428013538,346,1814,1760,54,267,79,0.851388888889,0.599277615973,0.599277615973
7,0,88,0.539007092199,0.866270430906,0.219653179191,0.964167585447,0.312114989733,0.912601095747,346,1814,1749,65,270,76,0.844907407407,0.591910382319,0.591910382319
7,0,89,0.521126760563,0.866699702676,0.215743440233,0.962575674188,0.305154639175,0.912125162973,343,1817,1749,68,269,74,0.843981481481,0.589159557211,0.589159557211
7,0,90,0.538461538462,0.864154685176,0.219373219373,0.963515754561,0.311740890688,0.911134343962,351,1809,1743,66,274,77,0.842592592593,0.591444486967,0.591444486967
7,0,91,0.532846715328,0.868512110727,0.215339233038,0.964854475563,0.306722689076,0.914151925078,339,1821,1757,64,266,73,0.847222222222,0.590096854301,0.590096854301
7,0,92,0.52380952381,0.872329855936,0.230538922156,0.961664841183,0.320166320166,0.914821568117,334,1826,1756,70,257,77,0.848611111111,0.596101881669,0.596101881669
7,0,93,0.547945205479,0.867924528302,0.231213872832,0.96361631753,0.325203252033,0.913270637409,346,1814,1748,66,266,80,0.846296296296,0.597415095181,0.597415095181
7,0,94,0.526717557252,0.864958107442,0.201166180758,0.965877820583,0.291139240506,0.91263650546,343,1817,1755,62,274,69,0.844444444444,0.583522000671,0.583522000671
7,0,95,0.549295774648,0.867690782953,0.226086956522,0.964738292011,0.320328542094,0.913644664753,345,1815,1751,64,267,78,0.846759259259,0.595412624266,0.595412624266
7,0,96,0.569105691057,0.86941580756,0.208333333333,0.970942982456,0.305010893246,0.917378917379,336,1824,1771,53,266,70,0.852314814815,0.589638157895,0.589638157895
7,0,97,0.534351145038,0.868408082799,0.207715133531,0.966538672518,0.299145299145,0.914849428868,337,1823,1762,61,267,70,0.848148148148,0.587126903024,0.587126903024
7,0,98,0.546762589928,0.867887184562,0.221574344023,0.965327462851,0.315352697095,0.914017717561,343,1817,1754,63,267,76,0.847222222222,0.593450903437,0.593450903437
7,0,99,0.544776119403,0.864264560711,0.209770114943,0.966335540839,0.302904564315,0.912454403335,348,1812,1751,61,275,73,0.844444444444,0.588052827891,0.588052827891
9,0,0,0.608695652174,0.870415647922,0.208955223881,0.975342465753,0.311111111111,0.919896640827,335,1825,1780,45,265,70,0.856481481481,0.592148844817,0.592148844817
9,0,1,0.557522123894,0.866145578896,0.186943620178,0.972572682392,0.28,0.916279069767,337,1823,1773,50,274,63,0.85,0.579758151285,0.579758151285
9,0,2,0.589285714286,0.86181640625,0.189111747851,0.974599668691,0.286334056399,0.914744752527,349,1811,1765,46,283,66,0.847685185185,0.581855708271,0.581855708271
9,0,3,0.581196581197,0.863925599608,0.196531791908,0.972987872106,0.29373650108,0.915219082188,346,1814,1765,49,278,68,0.848611111111,0.584759832007,0.584759832007
9,0,4,0.601851851852,0.862085769981,0.186781609195,0.976269315673,0.285087719298,0.915631469979,348,1812,1769,43,283,65,0.849074074074,0.581525462434,0.581525462434
9,0,5,0.631067961165,0.866310160428,0.191176470588,0.979120879121,0.293453724605,0.919267474852,340,1820,1782,38,275,65,0.855092592593,0.585148674855,0.585148674855
9,0,6,0.591666666667,0.866176470588,0.206395348837,0.973017621145,0.306034482759,0.916493775934,344,1816,1767,49,273,71,0.850925925926,0.589706484991,0.589706484991
9,0,7,0.62,0.861650485437,0.178674351585,0.979040264755,0.2774049217,0.916602117222,347,1813,1775,38,285,62,0.850462962963,0.57885730817,0.57885730817
9,0,8,0.594594594595,0.8682284041,0.196428571429,0.975328947368,0.295302013423,0.918667699458,336,1824,1779,45,270,66,0.854166666667,0.585878759398,0.585878759398
9,0,9,0.605263157895,0.86265884653,0.197142857143,0.975138121547,0.297413793103,0.915456431535,350,1810,1765,45,281,69,0.849074074074,0.586140489345,0.586140489345
9,0,10,0.616822429907,0.864588407209,0.191860465116,0.977422907489,0.292682926829,0.917549754459,344,1816,1775,41,278,66,0.852314814815,0.584641686303,0.584641686303
9,0,11,0.618181818182,0.861463414634,0.193181818182,0.976769911504,0.294372294372,0.915500259202,352,1808,1766,42,284,68,0.849074074074,0.584975864843,0.584975864843
9,0,12,0.603603603604,0.866764275256,0.197058823529,0.975824175824,0.29711751663,0.918066683898,340,1820,1776,44,273,67,0.853240740741,0.586441499677,0.586441499677
9,0,13,0.55905511811,0.863748155435,0.204022988506,0.969094922737,0.298947368421,0.913394018205,348,1812,1756,56,277,71,0.845833333333,0.586558955622,0.586558955622
9,0,14,0.614035087719,0.86412512219,0.201149425287,0.975717439294,0.30303030303,0.916537065837,348,1812,1768,44,278,70,0.850925925926,0.58843343229,0.58843343229
9,0,15,0.578512396694,0.866110838646,0.204081632653,0.971931755641,0.301724137931,0.915975103734,343,1817,1766,51,273,70,0.85,0.588006694147,0.588006694147
9,0,16,0.566037735849,0.867088607595,0.18018018018,0.974822112753,0.273348519362,0.917804689513,333,1827,1781,46,273,60,0.852314814815,0.577501146467,0.577501146467
9,0,17,0.616071428571,0.8662109375,0.201166180758,0.976334617501,0.303296703297,0.917981888745,343,1817,1774,43,274,69,0.853240740741,0.58875039913,0.58875039913
9,0,18,0.558558558559,0.869692532943,0.188449848024,0.973238667395,0.281818181818,0.918556701031,329,1831,1782,49,267,62,0.853703703704,0.58084425771,0.58084425771
9,0,19,0.59649122807,0.862170087977,0.194285714286,0.974585635359,0.293103448276,0.914937759336,350,1810,1764,46,282,68,0.848148148148,0.584435674822,0.584435674822
9,0,20,0.591304347826,0.867970660147,0.201183431953,0.97420417124,0.300220750552,0.918024308249,338,1822,1775,47,270,68,0.853240740741,0.587693801597,0.587693801597
9,0,21,0.623931623932,0.864415075869,0.208571428571,0.975690607735,0.312633832976,0.916688294835,350,1810,1766,44,277,73,0.851388888889,0.592131018153,0.592131018153
9,0,22,0.612068965517,0.870352250489,0.21130952381,0.975328947368,0.314159292035,0.919855222337,336,1824,1779,45,265,71,0.856481481481,0.593319235589,0.593319235589
9,0,23,0.591666666667,0.86862745098,0.209439528024,0.973091707853,0.309368191721,0.917896917897,339,1821,1772,49,268,71,0.853240740741,0.591265617938,0.591265617938
9,0,24,0.571428571429,0.86669921875,0.189910979228,0.973669775096,0.285077951002,0.917075691036,337,1823,1775,48,273,64,0.851388888889,0.581790377162,0.581790377162
9,0,25,0.625,0.8603515625,0.196629213483,0.976718403548,0.299145299145,0.914849428868,356,1804,1762,42,286,70,0.848148148148,0.586673808515,0.586673808515
9,0,26,0.6,0.864547677262,0.199421965318,0.974641675854,0.299349240781,0.916299559471,346,1814,1768,46,277,69,0.850462962963,0.587031820586,0.587031820586
9,0,27,0.515873015873,0.864798426745,0.191176470588,0.966483516484,0.278969957082,0.912817851583,340,1820,1759,61,275,65,0.844444444444,0.578829993536,0.578829993536
9,0,28,0.607142857143,0.8662109375,0.198830409357,0.975797579758,0.299559471366,0.917744438696,342,1818,1774,44,274,68,0.852777777778,0.587313994557,0.587313994557
9,0,29,0.573770491803,0.868989205103,0.207715133531,0.971475589687,0.305010893246,0.917378917379,337,1823,1771,52,267,70,0.852314814815,0.589595361609,0.589595361609
9,0,30,0.559633027523,0.86445636275,0.17994100295,0.973640856672,0.272321428571,0.915805785124,339,1821,1773,48,278,61,0.849074074074,0.576790929811,0.576790929811
9,0,31,0.616666666667,0.86568627451,0.212643678161,0.974613686534,0.316239316239,0.916926272066,348,1812,1766,46,274,74,0.851851851852,0.593628682348,0.593628682348
9,0,32,0.603773584906,0.860759493671,0.182857142857,0.97679558011,0.280701754386,0.915113871636,350,1810,1768,42,286,64,0.848148148148,0.579826361484,0.579826361484
9,0,33,0.549180327869,0.862119725221,0.192528735632,0.969646799117,0.285106382979,0.912727272727,348,1812,1757,55,281,67,0.844444444444,0.581087767375,0.581087767375
9,0,34,0.579439252336,0.860691670726,0.17816091954,0.975165562914,0.272527472527,0.914359637775,348,1812,1767,45,286,62,0.846759259259,0.576663241227,0.576663241227
9,0,35,0.598290598291,0.868330885952,0.206489675516,0.974190005491,0.30701754386,0.918219461698,339,1821,1774,47,269,70,0.853703703704,0.590339840504,0.590339840504
9,0,36,0.584905660377,0.861246348588,0.178674351585,0.975730832874,0.273730684327,0.914921127489,347,1813,1769,44,285,62,0.847685185185,0.577202592229,0.577202592229
9,0,37,0.601694915254,0.871204701273,0.212574850299,0.97426067908,0.314159292035,0.919855222337,334,1826,1779,47,263,71,0.856481481481,0.59341776469,0.59341776469
9,0,38,0.578947368421,0.863636363636,0.191304347826,0.973553719008,0.287581699346,0.915306915307,345,1815,1767,48,279,66,0.848611111111,0.582429033417,0.582429033417
9,0,39,0.571428571429,0.86865234375,0.192192192192,0.973727422003,0.287640449438,0.918193548387,333,1827,1779,48,269,64,0.853240740741,0.582959807098,0.582959807098
9,0,40,0.579831932773,0.868691817736,0.204747774481,0.972572682392,0.302631578947,0.917701863354,337,1823,1773,50,268,69,0.852777777778,0.588660228436,0.588660228436
9,0,41,0.592920353982,0.866145578896,0.196480938416,0.974711379879,0.295154185022,0.917227108122,341,1819,1773,46,274,67,0.851851851852,0.585596159148,0.585596159148
9,0,42,0.558558558559,0.864812103465,0.182890855457,0.973091707853,0.275555555556,0.915762273902,339,1821,1772,49,277,62,0.849074074074,0.577991281655,0.577991281655
9,0,43,0.573913043478,0.866992665037,0.195266272189,0.9731064764,0.291390728477,0.916989914663,338,1822,1773,49,272,66,0.851388888889,0.584186374294,0.584186374294
9,0,44,0.6015625,0.866633858268,0.221264367816,0.971854304636,0.323529411765,0.916233090531,348,1812,1761,51,271,77,0.850925925926,0.596559336226,0.596559336226
9,0,45,0.609523809524,0.860340632603,0.182336182336,0.9773355445,0.280701754386,0.915113871636,351,1809,1768,41,287,64,0.848148148148,0.579835863418,0.579835863418
9,0,46,0.617391304348,0.864547677262,0.204022988506,0.975717439294,0.306695464363,0.916774695359,348,1812,1768,44,277,71,0.851388888889,0.5898702139,0.5898702139
9,0,47,0.6,0.865853658537,0.193548387097,0.975810885102,0.292682926829,0.917549754459,341,1819,1775,44,275,66,0.852314814815,0.584679636099,0.584679636099
9,0,48,0.58407079646,0.864680019541,0.192419825073,0.974133186571,0.289473684211,0.916149068323,343,1817,1770,47,277,66,0.85,0.583276505822,0.583276505822
9,0,49,0.565217391304,0.866014669927,0.191740412979,0.972542559033,0.286343612335,0.916192446974,339,1821,1771,50,274,65,0.85,0.582141486006,0.582141486006
9,0,50,0.595041322314,0.868563021089,0.211764705882,0.973076923077,0.312364425163,0.917854366416,340,1820,1771,49,268,72,0.853240740741,0.59242081448,0.59242081448
9,0,51,0.545454545455,0.866110838646,0.194690265487,0.969796814937,0.286956521739,0.915025906736,339,1821,1766,55,273,66,0.848148148148,0.582243540212,0.582243540212
9,0,52,0.584745762712,0.864348677767,0.199421965318,0.972987872106,0.297413793103,0.915456431535,346,1814,1765,49,277,69,0.849074074074,0.586204918712,0.586204918712
9,0,53,0.608695652174,0.865525672372,0.202898550725,0.97520661157,0.304347826087,0.917098445596,345,1815,1770,45,275,70,0.851851851852,0.589052581147,0.589052581147
9,0,54,0.611570247934,0.868563021089,0.216374269006,0.974147414741,0.319654427646,0.91833030853,342,1818,1771,47,268,74,0.854166666667,0.595260841874,0.595260841874
9,0,55,0.605504587156,0.862018527548,0.189111747851,0.976256212038,0.288209606987,0.915587778353,349,1811,1768,43,283,66,0.849074074074,0.582683979944,0.582683979944
9,0,56,0.603773584906,0.860759493671,0.182857142857,0.97679558011,0.280701754386,0.915113871636,350,1810,1768,42,286,64,0.848148148148,0.579826361484,0.579826361484
9,0,57,0.608695652174,0.863080684597,0.2,0.975138121547,0.301075268817,0.915693904021,350,1810,1765,45,280,70,0.849537037037,0.587569060773,0.587569060773
9,0,58,0.586206896552,0.863992172211,0.196531791908,0.973539140022,0.294372294372,0.915500259202,346,1814,1766,48,278,68,0.849074074074,0.585035465965,0.585035465965
9,0,59,0.615384615385,0.863813229572,0.186046511628,0.977973568282,0.285714285714,0.917355371901,344,1816,1776,40,280,64,0.851851851852,0.582010039955,0.582010039955
9,0,60,0.567567567568,0.862859931674,0.183139534884,0.973568281938,0.276923076923,0.914877102199,344,1816,1768,48,281,63,0.847685185185,0.578353908411,0.578353908411
9,0,61,0.576271186441,0.86777668952,0.201183431953,0.972557628979,0.298245614035,0.91718426501,338,1822,1772,50,270,68,0.851851851852,0.586870530466,0.586870530466
9,0,62,0.55737704918,0.867026496565,0.200589970501,0.970345963756,0.295010845987,0.91578129049,339,1821,1767,54,271,68,0.849537037037,0.585467967129,0.585467967129
9,0,63,0.612612612613,0.862859931674,0.194842406877,0.976256212038,0.295652173913,0.916062176166,349,1811,1768,43,281,68,0.85,0.585549309457,0.585549309457
9,0,64,0.538461538462,0.866862457171,0.188059701493,0.970410958904,0.278761061947,0.915718717684,335,1825,1771,54,272,63,0.849074074074,0.579235330198,0.579235330198
9,0,65,0.584745762712,0.866797257591,0.202346041056,0.973062122045,0.300653594771,0.916860916861,341,1819,1770,49,272,69,0.851388888889,0.58770408155,0.58770408155
9,0,66,0.612612612613,0.866276232308,0.198830409357,0.976347634763,0.300220750552,0.918024308249,342,1818,1775,43,274,68,0.853240740741,0.58758902206,0.58758902206
9,0,67,0.598130841121,0.862640038967,0.184971098266,0.976295479603,0.282560706402,0.915955521076,346,1814,1771,43,282,64,0.849537037037,0.580633288934,0.580633288934
9,0,68,0.547008547009,0.867351933431,0.191044776119,0.97095890411,0.283185840708,0.916235780765,335,1825,1772,53,271,64,0.85,0.581001840114,0.581001840114
9,0,69,0.62962962963,0.86306042885,0.194842406877,0.977912755384,0.297592997812,0.916903960652,349,1811,1771,40,281,68,0.851388888889,0.58637758113,0.58637758113
9,0,70,0.627272727273,0.862926829268,0.197142857143,0.977348066298,0.3,0.916580310881,350,1810,1769,41,281,69,0.850925925926,0.587245461721,0.587245461721
9,0,71,0.59,0.86067961165,0.170520231214,0.977398015436,0.264573991031,0.915332989158,346,1814,1773,41,287,59,0.848148148148,0.573959123325,0.573959123325
9,0,72,0.595041322314,0.862677783227,0.204545454545,0.972898230088,0.3044397463,0.914478814661,352,1808,1759,49,280,72,0.847685185185,0.588721842317,0.588721842317
9,0,73,0.567796610169,0.866797257591,0.197640117994,0.971993410214,0.293216630197,0.91638622832,339,1821,1770,51,272,67,0.850462962963,0.584816764104,0.584816764104
9,0,74,0.586206896552,0.86252446184,0.194842406877,0.973495306461,0.29247311828,0.914656290532,349,1811,1763,48,281,68,0.847685185185,0.584168856669,0.584168856669
9,0,75,0.603603603604,0.866764275256,0.197058823529,0.975824175824,0.29711751663,0.918066683898,340,1820,1776,44,273,67,0.853240740741,0.586441499677,0.586441499677
9,0,76,0.586206896552,0.870352250489,0.204204204204,0.973727422003,0.30289532294,0.91914234048,333,1827,1779,48,265,68,0.855092592593,0.588965813104,0.588965813104
9,0,77,0.609090909091,0.863902439024,0.193641618497,0.976295479603,0.293859649123,0.916666666667,346,1814,1771,43,279,67,0.850925925926,0.58496854905,0.58496854905
9,0,78,0.634782608696,0.866014669927,0.210374639769,0.976833976834,0.316017316017,0.918092275791,347,1813,1771,42,274,73,0.853703703704,0.593604308302,0.593604308302
9,0,79,0.581818181818,0.863902439024,0.186588921283,0.974683544304,0.282560706402,0.915955521076,343,1817,1771,46,279,64,0.849537037037,0.580636232793,0.580636232793
9,0,80,0.577981651376,0.865919063871,0.186390532544,0.974753018661,0.281879194631,0.917118512781,338,1822,1776,46,275,63,0.851388888889,0.580571775603,0.580571775603
9,0,81,0.6,0.870098039216,0.213649851632,0.973669775096,0.315098468271,0.918974889982,337,1823,1775,48,265,72,0.855092592593,0.593659813364,0.593659813364
9,0,82,0.560747663551,0.861178762786,0.173913043478,0.974104683196,0.265486725664,0.914167528438,345,1815,1768,47,285,60,0.846296296296,0.574008863337,0.574008863337
9,0,83,0.614678899083,0.862506094588,0.191977077364,0.976808393153,0.292576419214,0.916105644744,349,1811,1769,42,282,67,0.85,0.584392735258,0.584392735258
9,0,84,0.660550458716,0.869332033155,0.211764705882,0.97967032967,0.320712694878,0.921208989925,340,1820,1783,37,268,72,0.858796296296,0.595717517776,0.595717517776
9,0,85,0.660550458716,0.866894197952,0.208695652174,0.979614325069,0.31718061674,0.919813760993,345,1815,1778,37,273,72,0.856481481481,0.594154988621,0.594154988621
9,0,86,0.616822429907,0.872868972236,0.201834862385,0.977632296781,0.304147465438,0.922285126094,327,1833,1792,41,261,66,0.860185185185,0.589733579583,0.589733579583
9,0,87,0.566371681416,0.868099658036,0.191616766467,0.973165388828,0.286353467562,0.91763490834,334,1826,1777,49,270,64,0.852314814815,0.582391077648,0.582391077648
9,0,88,0.576271186441,0.865817825661,0.198830409357,0.972497249725,0.295652173913,0.916062176166,342,1818,1768,50,274,68,0.85,0.585663829541,0.585663829541
9,0,89,0.594827586207,0.870352250489,0.206586826347,0.97426067908,0.306666666667,0.919379844961,334,1826,1779,47,265,69,0.855555555556,0.590423752714,0.590423752714
9,0,90,0.603773584906,0.864654333009,0.187134502924,0.976897689769,0.285714285714,0.917355371901,342,1818,1776,42,278,64,0.851851851852,0.582016096346,0.582016096346
9,0,91,0.565217391304,0.867970660147,0.194029850746,0.972602739726,0.288888888889,0.917312661499,335,1825,1775,50,270,65,0.851851851852,0.583316295236,0.583316295236
9,0,92,0.573913043478,0.868948655257,0.197604790419,0.973165388828,0.293986636971,0.918109015758,334,1826,1777,49,268,66,0.853240740741,0.585385089624,0.585385089624
9,0,93,0.582524271845,0.864851725814,0.177514792899,0.976399560922,0.272108843537,0.91724671307,338,1822,1779,43,278,60,0.851388888889,0.576957176911,0.576957176911
9,0,94,0.5625,0.8603515625,0.180515759312,0.972943125345,0.273318872017,0.913189945582,349,1811,1762,49,286,63,0.844907407407,0.576729442329,0.576729442329
9,0,95,0.583333333333,0.864035087719,0.184210526316,0.975247524752,0.28,0.916279069767,342,1818,1773,45,279,63,0.85,0.579729025534,0.579729025534
9,0,96,0.613445378151,0.867221950024,0.212209302326,0.974669603524,0.315334773218,0.917811770806,344,1816,1770,46,271,73,0.853240740741,0.593439452925,0.593439452925
9,0,97,0.634920634921,0.871189773845,0.233918128655,0.974697469747,0.34188034188,0.920041536864,342,1818,1772,46,262,80,0.857407407407,0.604307799201,0.604307799201
9,0,98,0.603603603604,0.861395802831,0.190883190883,0.975677169707,0.290043290043,0.914981855884,351,1809,1765,44,284,67,0.848148148148,0.583280180295,0.583280180295
9,0,99,0.547619047619,0.869223205506,0.205970149254,0.968767123288,0.299349240781,0.916299559471,335,1825,1768,57,266,69,0.850462962963,0.587368636271,0.587368636271
11,0,0,0.617647058824,0.87074829932,0.191489361702,0.978700163845,0.292343387471,0.921573669324,329,1831,1792,39,266,63,0.858796296296,0.585094762774,0.585094762774
11,0,1,0.617021276596,0.864472410455,0.171597633136,0.980241492865,0.268518518519,0.918724279835,338,1822,1786,36,280,58,0.853703703704,0.575919563001,0.575919563001
11,0,2,0.6375,0.858653846154,0.147826086957,0.984022038567,0.24,0.917073170732,345,1815,1786,29,294,51,0.850462962963,0.565924062762,0.565924062762
11,0,3,0.621359223301,0.864851725814,0.187134502924,0.978547854785,0.287640449438,0.918193548387,342,1818,1779,39,278,64,0.853240740741,0.582841178855,0.582841178855
11,0,4,0.656862745098,0.867832847425,0.197640117994,0.980779791323,0.303854875283,0.920855890693,339,1821,1786,35,272,67,0.85787037037,0.589209954659,0.589209954659
11,0,5,0.656565656566,0.865114022319,0.189504373178,0.981287837094,0.294117647059,0.919546157813,343,1817,1783,34,278,65,0.855555555556,0.585396105136,0.585396105136
11,0,6,0.652173913043,0.863636363636,0.175438596491,0.982398239824,0.276497695853,0.919197117859,342,1818,1786,32,282,60,0.85462962963,0.578918418158,0.578918418158
11,0,7,0.64,0.867961165049,0.190476190476,0.980263157895,0.293577981651,0.92070030896,336,1824,1788,36,272,64,0.857407407407,0.585369674185,0.585369674185
11,0,8,0.632653061224,0.860329776916,0.177142857143,0.980110497238,0.276785714286,0.91632231405,350,1810,1774,36,288,62,0.85,0.57862667719,0.57862667719
11,0,9,0.666666666667,0.868510431829,0.195845697329,0.981897970378,0.302752293578,0.921730175077,337,1823,1790,33,271,66,0.859259259259,0.588871833854,0.588871833854
11,0,10,0.655913978495,0.865505563619,0.17994100295,0.982427237781,0.282407407407,0.920267489712,339,1821,1789,32,278,61,0.856481481481,0.581184120366,0.581184120366
11,0,11,0.666666666667,0.86491739553,0.196531791908,0.981256890849,0.303571428571,0.919421487603,346,1814,1780,34,278,68,0.855555555556,0.588894341378,0.588894341378
11,0,12,0.638095238095,0.866666666667,0.196480938416,0.97910940077,0.300448430493,0.919463087248,341,1819,1781,38,274,67,0.855555555556,0.587795169593,0.587795169593
11,0,13,0.695652173913,0.860251450677,0.181303116147,0.984504703929,0.287640449438,0.918193548387,353,1807,1779,28,289,64,0.853240740741,0.582903910038,0.582903910038
11,0,14,0.631067961165,0.87117160914,0.19696969697,0.979234972678,0.300230946882,0.922047851814,330,1830,1792,38,265,65,0.859722222222,0.588102334824,0.588102334824
11,0,15,0.645161290323,0.85679729076,0.168539325843,0.981707317073,0.267260579065,0.915009041591,356,1804,1771,33,296,60,0.847685185185,0.575123321458,0.575123321458
11,0,16,0.63,0.86359223301,0.183139534884,0.979625550661,0.283783783784,0.917956656347,344,1816,1779,37,281,63,0.852777777778,0.581382542772,0.581382542772
11,0,17,0.670103092784,0.866698982065,0.191176470588,0.982417582418,0.297482837529,0.920937419521,340,1820,1788,32,275,65,0.85787037037,0.586797026503,0.586797026503
11,0,18,0.617021276596,0.865440464666,0.172619047619,0.980263157895,0.26976744186,0.919280205656,336,1824,1788,36,278,58,0.85462962963,0.576441102757,0.576441102757
11,0,19,0.677083333333,0.868701550388,0.193452380952,0.983004385965,0.300925925926,0.922325102881,336,1824,1793,31,271,65,0.860185185185,0.588228383459,0.588228383459
11,0,20,0.646464646465,0.859291606016,0.180790960452,0.980620155039,0.282560706402,0.915955521076,354,1806,1771,35,290,64,0.849537037037,0.580705557745,0.580705557745
11,0,21,0.67,0.867961165049,0.197640117994,0.981878088962,0.305239179954,0.921412007215,339,1821,1788,33,272,67,0.858796296296,0.589759103478,0.589759103478
11,0,22,0.639175257732,0.864760058168,0.181818181818,0.980758658604,0.283105022831,0.919113858836,341,1819,1784,35,279,62,0.85462962963,0.581288420211,0.581288420211
11,0,23,0.670212765957,0.861084220716,0.18,0.982872928177,0.283783783784,0.917956656347,350,1810,1779,31,287,63,0.852777777778,0.581436464088,0.581436464088
11,0,24,0.647619047619,0.864233576642,0.195965417867,0.979591836735,0.300884955752,0.918304033092,347,1813,1776,37,279,68,0.853703703704,0.587778627301,0.587778627301
11,0,25,0.647058823529,0.869290573372,0.197014925373,0.980273972603,0.302059496568,0.921452485192,335,1825,1789,36,269,66,0.858796296296,0.588644448988,0.588644448988
11,0,26,0.662921348315,0.861419604056,0.170520231214,0.983461962514,0.271264367816,0.918404118404,346,1814,1784,30,287,59,0.853240740741,0.576991096864,0.576991096864
11,0,27,0.618556701031,0.867183713039,0.179640718563,0.97973713034,0.278422273782,0.920030856261,334,1826,1789,37,274,60,0.856018518519,0.579688924451,0.579688924451
11,0,28,0.635416666667,0.868701550388,0.183734939759,0.980853391685,0.285046728972,0.921377183967,332,1828,1793,35,271,61,0.858333333333,0.582294165722,0.582294165722
11,0,29,0.583333333333,0.870857699805,0.192073170732,0.975436681223,0.288990825688,0.920185375901,328,1832,1787,45,265,63,0.856481481481,0.583754925977,0.583754925977
11,0,30,0.666666666667,0.857281083696,0.173669467787,0.982806433722,0.275555555556,0.915762273902,357,1803,1772,31,295,62,0.849074074074,0.578237950754,0.578237950754
11,0,31,0.641304347826,0.866537717602,0.176119402985,0.981917808219,0.276346604215,0.92062676599,335,1825,1792,33,276,59,0.856944444444,0.579018605602,0.579018605602
11,0,32,0.653465346535,0.863525983487,0.190201729107,0.980694980695,0.294642857143,0.918388429752,347,1813,1778,35,281,66,0.853703703704,0.585448354901,0.585448354901
11,0,33,0.607476635514,0.869459327813,0.195195195195,0.977011494253,0.295454545455,0.920103092784,333,1827,1785,42,268,65,0.856481481481,0.586103344724,0.586103344724
11,0,34,0.662921348315,0.859005311444,0.168091168091,0.983416252073,0.268181818182,0.917010309278,351,1809,1779,30,292,59,0.850925925926,0.575753710082,0.575753710082
11,0,35,0.581632653061,0.864694471387,0.169642857143,0.977521929825,0.26267281106,0.917653113742,336,1824,1783,41,279,57,0.851851851852,0.573582393484,0.573582393484
11,0,36,0.633663366337,0.868382710053,0.191044776119,0.979726027397,0.293577981651,0.92070030896,335,1825,1788,37,271,64,0.857407407407,0.585385401758,0.585385401758
11,0,37,0.583333333333,0.861918604651,0.1642228739,0.978009895547,0.256292906178,0.916301828483,341,1819,1779,40,285,56,0.849537037037,0.571116384724,0.571116384724
11,0,38,0.67032967033,0.863218946351,0.177325581395,0.983480176211,0.280459770115,0.919433719434,344,1816,1786,30,283,61,0.855092592593,0.580402878803,0.580402878803
11,0,39,0.636363636364,0.861003861004,0.162790697674,0.982378854626,0.259259259259,0.917695473251,344,1816,1784,32,288,56,0.851851851852,0.57258477615,0.57258477615
11,0,40,0.65306122449,0.866149369544,0.188235294118,0.981318681319,0.292237442922,0.920144255538,340,1820,1786,34,276,64,0.856481481481,0.584776987718,0.584776987718
11,0,41,0.691489361702,0.863504356244,0.187319884726,0.984004412576,0.294784580499,0.919824697087,347,1813,1784,29,282,65,0.856018518519,0.585662148651,0.585662148651
11,0,42,0.670454545455,0.862451737452,0.171511627907,0.984030837004,0.273148148148,0.919238683128,344,1816,1787,29,285,59,0.85462962963,0.577771232456,0.577771232456
11,0,43,0.607476635514,0.865075499269,0.190058479532,0.976897689769,0.289532293987,0.917592353397,342,1818,1776,42,277,65,0.852314814815,0.583478084651,0.583478084651
11,0,44,0.647058823529,0.866375121477,0.193548387097,0.980208905992,0.297968397291,0.919783337632,341,1819,1783,36,275,66,0.856018518519,0.586878646545,0.586878646545
11,0,45,0.621359223301,0.861934856587,0.183908045977,0.978476821192,0.283813747228,0.91651589558,348,1812,1773,39,284,64,0.850462962963,0.581192433585,0.581192433585
11,0,46,0.666666666667,0.866956942429,0.183976261128,0.982995063083,0.288372093023,0.921336760925,337,1823,1792,31,275,62,0.858333333333,0.583485662105,0.583485662105
11,0,47,0.676470588235,0.86491739553,0.198847262248,0.981798124655,0.307349665924,0.919659002842,347,1813,1780,33,278,69,0.856018518519,0.590322693452,0.590322693452
11,0,48,0.63829787234,0.868344627299,0.180722891566,0.981400437637,0.281690140845,0.921417565485,332,1828,1794,34,272,60,0.858333333333,0.581061664602,0.581061664602
11,0,49,0.652631578947,0.865375302663,0.182352941176,0.981868131868,0.285057471264,0.919948519949,340,1820,1787,33,278,62,0.856018518519,0.582110536522,0.582110536522
11,0,50,0.683673469388,0.860814742968,0.189265536723,0.982834994463,0.296460176991,0.91778697001,354,1806,1775,31,287,67,0.852777777778,0.586050265593,0.586050265593
11,0,51,0.652173913043,0.86750483559,0.179640718563,0.982475355969,0.281690140845,0.921417565485,334,1826,1794,32,274,60,0.858333333333,0.581058037266,0.581058037266
11,0,52,0.605769230769,0.864299610895,0.184210526316,0.977447744774,0.282511210762,0.917398038203,342,1818,1777,41,279,63,0.851851851852,0.580829135545,0.580829135545
11,0,53,0.684782608696,0.856866537718,0.175487465181,0.983897834536,0.279379157428,0.915998966141,359,1801,1772,29,296,63,0.849537037037,0.579692649859,0.579692649859
11,0,54,0.632653061224,0.863724539282,0.180758017493,0.980187121629,0.281179138322,0.918277906677,343,1817,1781,36,281,62,0.853240740741,0.580472569561,0.580472569561
11,0,55,0.674157303371,0.859005311444,0.170454545455,0.983960176991,0.272108843537,0.91724671307,352,1808,1779,29,292,60,0.851388888889,0.577207361223,0.577207361223
11,0,56,0.633663366337,0.866925692084,0.189349112426,0.979692645445,0.291571753986,0.919866013914,338,1822,1785,37,274,64,0.856018518519,0.584520878935,0.584520878935
11,0,57,0.6875,0.860949612403,0.186968838527,0.983397897067,0.293986636971,0.918109015758,353,1807,1777,30,287,66,0.853240740741,0.585183367797,0.585183367797
11,0,58,0.639175257732,0.860397479399,0.177142857143,0.980662983425,0.2774049217,0.916602117222,350,1810,1775,35,288,62,0.850462962963,0.578902920284,0.578902920284
11,0,59,0.627659574468,0.860600193611,0.170028818444,0.980694980695,0.267573696145,0.916731116267,347,1813,1778,35,288,59,0.850462962963,0.575361899569,0.575361899569
11,0,60,0.655172413793,0.860106126387,0.164265129683,0.983452840596,0.26267281106,0.917653113742,347,1813,1783,30,290,57,0.851851851852,0.573858985139,0.573858985139
11,0,61,0.681318681319,0.860802319961,0.177142857143,0.983977900552,0.281179138322,0.918277906677,350,1810,1781,29,288,62,0.853240740741,0.580560378848,0.580560378848
11,0,62,0.623529411765,0.864578313253,0.158682634731,0.982475355969,0.252983293556,0.919764163035,334,1826,1794,32,281,53,0.855092592593,0.57057899535,0.57057899535
11,0,63,0.62962962963,0.868421052632,0.201183431953,0.978046103183,0.304932735426,0.91997934951,338,1822,1782,40,270,68,0.856481481481,0.589614767568,0.589614767568
11,0,64,0.698924731183,0.863086598936,0.186781609195,0.984547461369,0.294784580499,0.919824697087,348,1812,1784,28,283,65,0.856018518519,0.585664535282,0.585664535282
11,0,65,0.647619047619,0.862287104623,0.193732193732,0.97954671089,0.298245614035,0.91718426501,351,1809,1772,37,283,68,0.851851851852,0.586639452311,0.586639452311
11,0,66,0.649484536082,0.864275327193,0.183673469388,0.981287837094,0.286363636364,0.919072164948,343,1817,1783,34,280,63,0.85462962963,0.582480653241,0.582480653241
11,0,67,0.666666666667,0.867540029112,0.194690265487,0.981878088962,0.301369863014,0.921174652241,339,1821,1788,33,273,66,0.858333333333,0.588284177224,0.588284177224
11,0,68,0.639534883721,0.862102217936,0.161290322581,0.982957669049,0.257611241218,0.91857179553,341,1819,1788,31,286,55,0.853240740741,0.572123995815,0.572123995815
11,0,69,0.712765957447,0.861568247822,0.189801699717,0.98505810736,0.299776286353,0.919184095017,353,1807,1780,27,286,67,0.855092592593,0.587429903538,0.587429903538
11,0,70,0.651162790698,0.864995178399,0.166666666667,0.983552631579,0.265402843602,0.920472036942,336,1824,1794,30,280,56,0.856481481481,0.575109649123,0.575109649123
11,0,71,0.659793814433,0.86282113427,0.184438040346,0.981798124655,0.288288288288,0.918472652219,347,1813,1780,33,283,64,0.853703703704,0.583118082501,0.583118082501
11,0,72,0.655172413793,0.862035697057,0.166180758017,0.983489268024,0.26511627907,0.918766066838,343,1817,1787,30,286,57,0.853703703704,0.574835013021,0.574835013021
11,0,73,0.622448979592,0.860329776916,0.174785100287,0.97956929873,0.27293064877,0.916085721663,349,1811,1774,37,288,61,0.849537037037,0.577177199508,0.577177199508
11,0,74,0.635294117647,0.859759036145,0.15652173913,0.982920110193,0.251162790698,0.917223650386,345,1815,1784,31,291,54,0.850925925926,0.569720924662,0.569720924662
11,0,75,0.722891566265,0.863745787193,0.174927113703,0.987341772152,0.281690140845,0.921417565485,343,1817,1794,23,283,60,0.858333333333,0.581134442927,0.581134442927
11,0,76,0.636363636364,0.858806404658,0.177966101695,0.980066445183,0.278145695364,0.915438324282,354,1806,1770,36,291,63,0.848611111111,0.579016273439,0.579016273439
11,0,77,0.629213483146,0.863351038146,0.165191740413,0.981878088962,0.261682242991,0.918807810894,339,1821,1788,33,283,56,0.853703703704,0.573534914688,0.573534914688
11,0,78,0.640776699029,0.865824015557,0.19298245614,0.979647964796,0.296629213483,0.919225806452,342,1818,1781,37,276,66,0.855092592593,0.586315210468,0.586315210468
11,0,79,0.64,0.864077669903,0.186046511628,0.980176211454,0.288288288288,0.918472652219,344,1816,1780,36,280,64,0.853703703704,0.583111361541,0.583111361541
11,0,80,0.698924731183,0.860183841316,0.183615819209,0.984496124031,0.290827740492,0.918151303899,354,1806,1778,28,289,65,0.853240740741,0.58405597162,0.58405597162
11,0,81,0.633333333333,0.86231884058,0.166666666667,0.981848184818,0.263888888889,0.918209876543,342,1818,1785,33,285,57,0.852777777778,0.574257425743,0.574257425743
11,0,82,0.61,0.866019417476,0.181008902077,0.978606692265,0.279176201373,0.918877156837,337,1823,1784,39,276,61,0.854166666667,0.579807797171,0.579807797171
11,0,83,0.614583333333,0.863856589147,0.173529411765,0.97967032967,0.270642201835,0.918125643666,340,1820,1783,37,281,59,0.852777777778,0.576599870718,0.576599870718
11,0,84,0.645833333333,0.860465116279,0.177142857143,0.981215469613,0.27802690583,0.916881775942,350,1810,1776,34,288,62,0.850925925926,0.579179163378,0.579179163378
11,0,85,0.681818181818,0.864864864865,0.176470588235,0.984615384615,0.280373831776,0.920863309353,340,1820,1792,28,280,60,0.857407407407,0.580542986425,0.580542986425
11,0,86,0.605504587156,0.865919063871,0.193548387097,0.976360637713,0.293333333333,0.917829457364,341,1819,1776,43,275,66,0.852777777778,0.584954512405,0.584954512405
11,0,87,0.648936170213,0.861568247822,0.175792507205,0.981798124655,0.27664399093,0.917762309874,347,1813,1780,33,286,61,0.852314814815,0.57879531593,0.57879531593
11,0,88,0.67,0.866504854369,0.195906432749,0.981848184818,0.303167420814,0.920577617329,342,1818,1785,33,275,67,0.857407407407,0.588877308784,0.588877308784
11,0,89,0.663043478261,0.859284332689,0.173295454545,0.982853982301,0.274774774775,0.916924664603,352,1808,1777,31,291,61,0.850925925926,0.578074718423,0.578074718423
11,0,90,0.636363636364,0.862451737452,0.1642228739,0.982407916438,0.261072261072,0.918529940889,341,1819,1787,32,285,56,0.853240740741,0.573315395169,0.573315395169
11,0,91,0.626262626263,0.866569626395,0.183976261128,0.97970378497,0.284403669725,0.919670442842,337,1823,1786,37,275,62,0.855555555556,0.581840023049,0.581840023049
11,0,92,0.628865979381,0.864760058168,0.179411764706,0.98021978022,0.279176201373,0.918877156837,340,1820,1784,36,279,61,0.854166666667,0.579815772463,0.579815772463
11,0,93,0.630434782609,0.862669245648,0.169590643275,0.981298129813,0.267281105991,0.918167781781,342,1818,1784,34,284,58,0.852777777778,0.575444386544,0.575444386544
11,0,94,0.67,0.866504854369,0.195906432749,0.981848184818,0.303167420814,0.920577617329,342,1818,1785,33,275,67,0.857407407407,0.588877308784,0.588877308784
11,0,95,0.619047619048,0.851637764933,0.144444444444,0.982222222222,0.234234234234,0.912280701754,360,1800,1768,32,308,52,0.842592592593,0.563333333333,0.563333333333
11,0,96,0.610526315789,0.862953995157,0.17008797654,0.979659153381,0.266055045872,0.917610710608,341,1819,1782,37,283,58,0.851851851852,0.57487356496,0.57487356496
11,0,97,0.592233009709,0.863393291201,0.178362573099,0.976897689769,0.274157303371,0.91664516129,342,1818,1776,42,281,61,0.850462962963,0.577630131434,0.577630131434
11,0,98,0.659340659341,0.862735621073,0.174418604651,0.982929515419,0.275862068966,0.918918918919,344,1816,1785,31,284,60,0.854166666667,0.578674060035,0.578674060035
11,0,99,0.659090909091,0.860521235521,0.167146974063,0.983452840596,0.266666666667,0.917889317889,347,1813,1783,30,289,58,0.852314814815,0.57529990733,0.57529990733
13,0,0,0.723684210526,0.859884836852,0.158501440922,0.988416988417,0.260047281324,0.919681806518,347,1813,1792,21,292,55,0.855092592593,0.57345921467,0.57345921467
13,0,1,0.635294117647,0.860240963855,0.156976744186,0.982929515419,0.251748251748,0.917501927525,344,1816,1785,31,290,54,0.851388888889,0.569953129802,0.569953129802
13,0,2,0.615384615385,0.866602223296,0.168674698795,0.980853391685,0.264775413712,0.920195021812,332,1828,1793,35,276,56,0.856018518519,0.57476404524,0.57476404524
13,0,3,0.641025641026,0.866474543708,0.15243902439,0.984716157205,0.246305418719,0.921819110884,328,1832,1804,28,278,50,0.858333333333,0.568577590798,0.568577590798
13,0,4,0.632183908046,0.860588519055,0.15988372093,0.982378854626,0.255220417633,0.917459501157,344,1816,1784,32,289,55,0.851388888889,0.571131287778,0.571131287778
13,0,5,0.697368421053,0.857005758157,0.150997150997,0.987285793256,0.248243559719,0.917544310301,351,1809,1786,23,298,53,0.851388888889,0.569141472127,0.569141472127
13,0,6,0.655913978495,0.863086598936,0.177325581395,0.982378854626,0.279176201373,0.918877156837,344,1816,1784,32,283,61,0.854166666667,0.57985221801,0.57985221801
13,0,7,0.686046511628,0.862102217936,0.171014492754,0.985123966942,0.273781902552,0.91951658524,345,1815,1788,27,286,59,0.855092592593,0.578069229848,0.578069229848
13,0,8,0.671232876712,0.861044561572,0.144542772861,0.986820428336,0.23786407767,0.919651995906,339,1821,1797,24,290,49,0.85462962963,0.565681600599,0.565681600599
13,0,9,0.670588235294,0.865060240964,0.169139465875,0.984640702139,0.270142180095,0.920985120575,337,1823,1795,28,280,57,0.857407407407,0.576890084007,0.576890084007
13,0,10,0.710843373494,0.861338468946,0.170028818444,0.986762272477,0.274418604651,0.919794344473,347,1813,1789,24,288,59,0.855555555556,0.57839554546,0.57839554546
13,0,11,0.64367816092,0.859141341052,0.16091954023,0.98289183223,0.257471264368,0.91685971686,348,1812,1781,31,292,56,0.850462962963,0.57190568623,0.57190568623
13,0,12,0.657894736842,0.864203454894,0.15015015015,0.985769020252,0.244498777506,0.920992073638,333,1827,1801,26,283,50,0.856944444444,0.567959585201,0.567959585201
13,0,13,0.686746987952,0.863264323544,0.16715542522,0.985706432106,0.268867924528,0.920431211499,341,1819,1793,26,284,57,0.856481481481,0.576430928663,0.576430928663
13,0,14,0.64,0.858992805755,0.140350877193,0.985148514851,0.230215827338,0.917755572636,342,1818,1791,27,294,48,0.851388888889,0.562749696022,0.562749696022
13,0,15,0.679012345679,0.867724867725,0.166666666667,0.985792349727,0.267639902676,0.922998209261,330,1830,1804,26,275,55,0.860648148148,0.576229508197,0.576229508197
13,0,16,0.657894736842,0.856525911708,0.143266475645,0.985643290999,0.235294117647,0.916559691913,349,1811,1785,26,299,50,0.849537037037,0.564454883322,0.564454883322
13,0,17,0.637362637363,0.864668922185,0.171597633136,0.981888035126,0.270396270396,0.919557954253,338,1822,1789,33,280,58,0.855092592593,0.576742834131,0.576742834131
13,0,18,0.682926829268,0.861886429259,0.163265306122,0.985690698954,0.263529411765,0.919640564827,343,1817,1791,26,287,56,0.855092592593,0.574478002538,0.574478002538
13,0,19,0.734375,0.857824427481,0.136231884058,0.990633608815,0.229828850856,0.919457939146,345,1815,1798,17,298,47,0.854166666667,0.563432746437,0.563432746437
13,0,20,0.67032967033,0.86563557274,0.17994100295,0.98352553542,0.283720930233,0.920822622108,339,1821,1791,30,278,61,0.857407407407,0.581733269185,0.581733269185
13,0,21,0.682926829268,0.858036573628,0.159544159544,0.985627418463,0.258660508083,0.917417031129,351,1809,1783,26,295,56,0.851388888889,0.572585789004,0.572585789004
13,0,22,0.641975308642,0.859547859548,0.151162790698,0.984030837004,0.244705882353,0.917586649551,344,1816,1787,29,292,52,0.851388888889,0.567596813851,0.567596813851
13,0,23,0.7,0.860576923077,0.161849710983,0.986769570011,0.262910798122,0.919363122753,346,1814,1790,24,290,56,0.85462962963,0.574309640497,0.574309640497
13,0,24,0.691358024691,0.856180856181,0.157746478873,0.986149584488,0.256880733945,0.91658084449,355,1805,1780,25,299,56,0.85,0.57194803168,0.57194803168
13,0,25,0.651685393258,0.862868179623,0.169590643275,0.982948294829,0.269141531323,0.91900231422,342,1818,1787,31,284,58,0.854166666667,0.576269469052,0.576269469052
13,0,26,0.680555555556,0.858237547893,0.142028985507,0.987327823691,0.235011990408,0.918267998975,345,1815,1792,23,296,49,0.852314814815,0.564678404599,0.564678404599
13,0,27,0.650602409639,0.859894077997,0.15652173913,0.984022038567,0.252336448598,0.917780061665,345,1815,1786,29,291,54,0.851851851852,0.570271888849,0.570271888849
13,0,28,0.691358024691,0.863395863396,0.164705882353,0.986263736264,0.266033254157,0.920748909977,340,1820,1795,25,284,56,0.856944444444,0.575484809308,0.575484809308
13,0,29,0.635294117647,0.861686746988,0.158357771261,0.982957669049,0.253521126761,0.918335901387,341,1819,1788,31,287,54,0.852777777778,0.570657720155,0.570657720155
13,0,30,0.634146341463,0.859961501444,0.151603498542,0.983489268024,0.244705882353,0.917586649551,343,1817,1787,30,291,52,0.851388888889,0.567546383283,0.567546383283
13,0,31,0.657894736842,0.860364683301,0.146627565982,0.985706432106,0.239808153477,0.918780425314,341,1819,1793,26,291,50,0.853240740741,0.566166999044,0.566166999044
13,0,32,0.657534246575,0.855294681361,0.137142857143,0.986187845304,0.22695035461,0.916089299461,350,1810,1785,25,302,48,0.848611111111,0.561665351223,0.561665351223
13,0,33,0.697368421053,0.865163147793,0.158682634731,0.987404162103,0.258536585366,0.922250639386,334,1826,1803,23,281,53,0.859259259259,0.573043398417,0.573043398417
13,0,34,0.7,0.858173076923,0.159544159544,0.986733001658,0.259860788863,0.917973772178,351,1809,1785,24,295,56,0.852314814815,0.573138580601,0.573138580601
13,0,35,0.64,0.860911270983,0.14201183432,0.985181119649,0.232445520581,0.918863578193,338,1822,1795,27,290,48,0.853240740741,0.563596476984,0.563596476984
13,0,36,0.658227848101,0.863046612206,0.154302670623,0.985189248491,0.25,0.920081967213,337,1823,1796,27,285,52,0.855555555556,0.569745959557,0.569745959557
13,0,37,0.639534883721,0.865959498554,0.165165165165,0.983032293377,0.262529832936,0.920789541143,333,1827,1796,31,278,55,0.856944444444,0.574098729271,0.574098729271
13,0,38,0.702380952381,0.864161849711,0.173020527859,0.986256184717,0.277647058824,0.921181001284,341,1819,1794,25,282,59,0.85787037037,0.579638356288,0.579638356288
13,0,39,0.633333333333,0.866183574879,0.170658682635,0.981927710843,0.268867924528,0.920431211499,334,1826,1793,33,277,57,0.856481481481,0.576293196739,0.576293196739
13,0,40,0.736842105263,0.855086372361,0.156424581006,0.988901220866,0.258064516129,0.917138445703,358,1802,1782,20,302,56,0.850925925926,0.572662900936,0.572662900936
13,0,41,0.627906976744,0.860655737705,0.157434402332,0.982388552559,0.251748251748,0.917501927525,343,1817,1785,32,289,54,0.851388888889,0.569911477446,0.569911477446
13,0,42,0.666666666667,0.861952861953,0.158357771261,0.985156679494,0.255924170616,0.919445869677,341,1819,1792,27,287,54,0.85462962963,0.571757225378,0.571757225378
13,0,43,0.662162162162,0.86481303931,0.148036253776,0.986331328595,0.241975308642,0.921583652618,331,1829,1804,25,282,49,0.85787037037,0.567183791186,0.567183791186
13,0,44,0.641025641026,0.856868395773,0.14367816092,0.984547461369,0.234741784038,0.916281458654,348,1812,1784,28,298,50,0.849074074074,0.564112811144,0.564112811144
13,0,45,0.654320987654,0.861471861472,0.155425219941,0.984606926883,0.251184834123,0.918932786044,341,1819,1791,28,288,53,0.853703703704,0.570016073412,0.570016073412
13,0,46,0.629213483146,0.861902462578,0.163742690058,0.981848184818,0.259860788863,0.917973772178,342,1818,1785,33,286,56,0.852314814815,0.572795437438,0.572795437438
13,0,47,0.658536585366,0.858999037536,0.155619596542,0.984555984556,0.251748251748,0.917501927525,347,1813,1785,28,293,54,0.851388888889,0.570087790549,0.570087790549
13,0,48,0.698795180723,0.861819932595,0.168115942029,0.986225895317,0.271028037383,0.919835560123,345,1815,1790,25,287,58,0.855555555556,0.577170918673,0.577170918673
13,0,49,0.678571428571,0.861271676301,0.165217391304,0.985123966942,0.265734265734,0.919043947571,345,1815,1788,27,288,57,0.854166666667,0.575170679123,0.575170679123
13,0,50,0.707317073171,0.858999037536,0.165242165242,0.986733001658,0.267898383372,0.918446102393,351,1809,1785,24,293,58,0.853240740741,0.57598758345,0.57598758345
13,0,51,0.67816091954,0.86155330439,0.170520231214,0.984564498346,0.272517321016,0.918960638024,346,1814,1786,28,287,59,0.854166666667,0.57754236478,0.57754236478
13,0,52,0.69512195122,0.85948026949,0.163323782235,0.986195472115,0.264501160093,0.918488043199,349,1811,1786,25,292,57,0.853240740741,0.574759627175,0.574759627175
13,0,53,0.632183908046,0.86348287506,0.162721893491,0.982436882547,0.258823529412,0.919127086008,338,1822,1790,32,283,55,0.854166666667,0.572579388019,0.572579388019
13,0,54,0.666666666667,0.86023054755,0.151603498542,0.985690698954,0.24703087886,0.918697101821,343,1817,1791,26,291,52,0.853240740741,0.568647098748,0.568647098748
13,0,55,0.675324675325,0.859337493999,0.150724637681,0.986225895317,0.24644549763,0.918419702411,345,1815,1790,25,293,52,0.852777777778,0.568475266499,0.568475266499
13,0,56,0.658823529412,0.861686746988,0.163265306122,0.984039625757,0.261682242991,0.918807810894,343,1817,1788,29,287,56,0.853703703704,0.57365246594,0.57365246594
13,0,57,0.657142857143,0.855023923445,0.131805157593,0.98674765323,0.219570405728,0.916175339656,349,1811,1787,24,303,46,0.848611111111,0.559276405412,0.559276405412
13,0,58,0.74358974359,0.85878962536,0.164772727273,0.988938053097,0.26976744186,0.919280205656,352,1808,1788,20,294,58,0.85462962963,0.576855390185,0.576855390185
13,0,59,0.646341463415,0.861405197305,0.155425219941,0.984057174272,0.250591016548,0.91865537593,341,1819,1790,29,288,53,0.853240740741,0.569741197106,0.569741197106
13,0,60,0.684931506849,0.861044561572,0.147058823529,0.987362637363,0.242130750605,0.919887381623,340,1820,1797,23,290,50,0.855092592593,0.567210730446,0.567210730446
13,0,61,0.696202531646,0.864488226814,0.163204747774,0.986834887548,0.264423076923,0.921618852459,337,1823,1799,24,282,55,0.858333333333,0.575019817661,0.575019817661
13,0,62,0.674698795181,0.859894077997,0.161383285303,0.985107556536,0.260465116279,0.918251928021,347,1813,1786,27,291,56,0.852777777778,0.573245420919,0.573245420919
13,0,63,0.650602409639,0.862301396245,0.158823529412,0.984065934066,0.255319148936,0.919168591224,340,1820,1791,29,286,54,0.854166666667,0.571444731739,0.571444731739
13,0,64,0.658536585366,0.860442733397,0.156976744186,0.984581497797,0.253521126761,0.918335901387,344,1816,1788,28,290,54,0.852777777778,0.570779120992,0.570779120992
13,0,65,0.633333333333,0.864734299517,0.169139465875,0.981897970378,0.266978922717,0.91959928076,337,1823,1790,33,280,57,0.855092592593,0.575518718127,0.575518718127
13,0,66,0.66265060241,0.856523832451,0.155807365439,0.984504703929,0.252293577982,0.916065911432,353,1807,1779,28,298,55,0.849074074074,0.570156034684,0.570156034684
13,0,67,0.6,0.864578313253,0.153614457831,0.981400437637,0.244604316547,0.919292851653,332,1828,1794,34,281,51,0.854166666667,0.567507447734,0.567507447734
13,0,68,0.647058823529,0.866506024096,0.165662650602,0.983588621444,0.263788968825,0.921342557007,332,1828,1798,30,277,55,0.85787037037,0.574625636023,0.574625636023
13,0,69,0.626506024096,0.863264323544,0.154761904762,0.983004385965,0.248210023866,0.919251473981,336,1824,1793,31,284,52,0.854166666667,0.568883145363,0.568883145363
13,0,70,0.679487179487,0.862632084534,0.156342182891,0.986271279517,0.254196642686,0.92031770433,339,1821,1796,25,286,53,0.856018518519,0.571306731204,0.571306731204
13,0,71,0.651162790698,0.859209257473,0.16091954023,0.983443708609,0.258064516129,0.917138445703,348,1812,1782,30,292,56,0.850925925926,0.57218162442,0.57218162442
13,0,72,0.7125,0.858173076923,0.161931818182,0.987278761062,0.263888888889,0.918209876543,352,1808,1785,23,295,57,0.852777777778,0.574605289622,0.574605289622
13,0,73,0.759493670886,0.856319077367,0.16713091922,0.989450305386,0.27397260274,0.918083462133,359,1801,1782,19,299,60,0.852777777778,0.578290612303,0.578290612303
13,0,74,0.654320987654,0.858104858105,0.152298850575,0.984547461369,0.247086247086,0.916987920843,348,1812,1784,28,295,53,0.850462962963,0.568423155972,0.568423155972
13,0,75,0.654761904762,0.861753371869,0.16081871345,0.98404840484,0.258215962441,0.91884951207,342,1818,1789,29,287,55,0.853703703704,0.572433559145,0.572433559145
13,0,76,0.717948717949,0.861671469741,0.162790697674,0.987885462555,0.265402843602,0.920472036942,344,1816,1794,22,288,56,0.856481481481,0.575338080115,0.575338080115
13,0,77,0.743243243243,0.86481303931,0.163204747774,0.989577619309,0.267639902676,0.922998209261,337,1823,1804,19,282,55,0.860648148148,0.576391183542,0.576391183542
13,0,78,0.705882352941,0.859277108434,0.170454545455,0.986172566372,0.274599542334,0.918362091167,352,1808,1783,25,292,60,0.853240740741,0.578313555913,0.578313555913
13,0,79,0.675,0.859615384615,0.156069364162,0.985667034179,0.253521126761,0.918335901387,346,1814,1788,26,292,54,0.852777777778,0.57086819917,0.57086819917
13,0,80,0.666666666667,0.863876863877,0.160237388724,0.985189248491,0.258373205742,0.920553562276,337,1823,1796,27,283,54,0.856481481481,0.572713318608,0.572713318608
13,0,81,0.686746987952,0.870486278286,0.174846625767,0.985823336968,0.278728606357,0.924571720788,326,1834,1808,26,269,57,0.863425925926,0.580334981368,0.580334981368
13,0,82,0.642857142857,0.863680154143,0.160237388724,0.983543609435,0.256532066508,0.919723005899,337,1823,1793,30,283,54,0.855092592593,0.57189049908,0.57189049908
13,0,83,0.670454545455,0.870173745174,0.17987804878,0.984170305677,0.283653846154,0.923668032787,328,1832,1803,29,269,59,0.862037037037,0.582024177229,0.582024177229
13,0,84,0.710144927536,0.860832137733,0.144117647059,0.989010989011,0.239608801956,0.920480695474,340,1820,1800,20,291,49,0.856018518519,0.566564318035,0.566564318035
13,0,85,0.670731707317,0.86333012512,0.162241887906,0.985172981878,0.261282660333,0.920235957938,339,1821,1794,27,284,55,0.856018518519,0.573707434892,0.573707434892
13,0,86,0.65625,0.856393129771,0.122448979592,0.987892129884,0.206388206388,0.917454638385,343,1817,1795,22,301,42,0.850462962963,0.555170554738,0.555170554738
13,0,87,0.694117647059,0.863614457831,0.172514619883,0.985698569857,0.276346604215,0.92062676599,342,1818,1792,26,283,59,0.856944444444,0.57910659487,0.57910659487
13,0,88,0.642857142857,0.861753371869,0.158357771261,0.98350742166,0.254117647059,0.918613607189,341,1819,1789,30,287,54,0.853240740741,0.570932596461,0.570932596461
13,0,89,0.666666666667,0.86050986051,0.156976744186,0.98513215859,0.254117647059,0.918613607189,344,1816,1789,27,290,54,0.853240740741,0.571054451388,0.571054451388
13,0,90,0.686746987952,0.859894077997,0.163793103448,0.985651214128,0.264501160093,0.918488043199,348,1812,1786,26,291,57,0.853240740741,0.574722158788,0.574722158788
13,0,91,0.679487179487,0.863112391931,0.156804733728,0.98627881449,0.254807692308,0.920594262295,338,1822,1797,25,285,53,0.856481481481,0.571541774109,0.571541774109
13,0,92,0.66265060241,0.857968223399,0.157142857143,0.98453038674,0.254041570439,0.916902495498,350,1810,1782,28,295,55,0.850462962963,0.570836621942,0.570836621942
13,0,93,0.6625,0.859134615385,0.153179190751,0.985115766262,0.24882629108,0.917822290704,346,1814,1787,27,293,53,0.851851851852,0.569147478507,0.569147478507
13,0,94,0.595238095238,0.862235067437,0.14880952381,0.981359649123,0.238095238095,0.917948717949,336,1824,1790,34,286,50,0.851851851852,0.565084586466,0.565084586466
13,0,95,0.646341463415,0.862367661213,0.156342182891,0.984074684239,0.251781472684,0.91921005386,339,1821,1792,29,286,53,0.854166666667,0.570208433565,0.570208433565
13,0,96,0.623529411765,0.864578313253,0.158682634731,0.982475355969,0.252983293556,0.919764163035,334,1826,1794,32,281,53,0.855092592593,0.57057899535,0.57057899535
13,0,97,0.606741573034,0.857073877354,0.154285714286,0.980662983425,0.246013667426,0.914712702912,350,1810,1775,35,296,54,0.846759259259,0.567474348856,0.567474348856
13,0,98,0.674418604651,0.868852459016,0.175757575758,0.984699453552,0.278846153846,0.923155737705,330,1830,1802,28,272,58,0.861111111111,0.580228514655,0.580228514655
13,0,99,0.666666666667,0.861271676301,0.162790697674,0.984581497797,0.261682242991,0.918807810894,344,1816,1788,28,288,56,0.853703703704,0.573686097736,0.573686097736
15,0,0,0.728571428571,0.856459330144,0.145299145299,0.989496959646,0.242280285036,0.918184149782,351,1809,1790,19,300,51,0.852314814815,0.567398052473,0.567398052473
15,0,1,0.75,0.865163147793,0.168639053254,0.989571899012,0.275362318841,0.923195084485,338,1822,1803,19,281,57,0.861111111111,0.579105476133,0.579105476133
15,0,2,0.776119402985,0.862876254181,0.153392330383,0.99176276771,0.256157635468,0.922841083291,339,1821,1806,15,287,52,0.860185185185,0.572577549047,0.572577549047
15,0,3,0.727272727273,0.862698031685,0.163742690058,0.988448844884,0.267303102625,0.921302230197,342,1818,1797,21,286,56,0.85787037037,0.576095767471,0.576095767471
15,0,4,0.735294117647,0.860420650096,0.146198830409,0.990099009901,0.243902439024,0.920716112532,342,1818,1800,18,292,50,0.856481481481,0.568148920155,0.568148920155
15,0,5,0.706896551724,0.86013320647,0.122388059701,0.990684931507,0.208651399491,0.920804685511,335,1825,1808,17,294,41,0.856018518519,0.556536495604,0.556536495604
15,0,6,0.723076923077,0.859665871122,0.137829912023,0.990104452996,0.231527093596,0.920286152274,341,1819,1801,18,294,47,0.855555555556,0.56396718251,0.56396718251
15,0,7,0.708860759494,0.862566074003,0.163742690058,0.987348734873,0.266033254157,0.920748909977,342,1818,1795,23,286,56,0.856944444444,0.575545712466,0.575545712466
15,0,8,0.64,0.861870503597,0.142857142857,0.985197368421,0.233576642336,0.919416730622,336,1824,1797,27,288,48,0.854166666667,0.564027255639,0.564027255639
15,0,9,0.722222222222,0.861111111111,0.152046783626,0.98899889989,0.251207729469,0.920634920635,342,1818,1798,20,290,52,0.856481481481,0.570522841758,0.570522841758
15,0,10,0.738461538462,0.855369928401,0.136752136752,0.990602542841,0.230769230769,0.918032786885,351,1809,1792,17,303,48,0.851851851852,0.563677339797,0.563677339797
15,0,11,0.704225352113,0.865964576352,0.151515151515,0.988524590164,0.249376558603,0.923194692524,330,1830,1809,21,280,50,0.860648148148,0.57001987084,0.57001987084
15,0,12,0.698630136986,0.859607091519,0.148255813953,0.987885462555,0.244604316547,0.919292851653,344,1816,1794,22,293,51,0.854166666667,0.568070638254,0.568070638254
15,0,13,0.685714285714,0.86028708134,0.141176470588,0.987912087912,0.234146341463,0.919693094629,340,1820,1798,22,292,48,0.85462962963,0.56454427925,0.56454427925
15,0,14,0.72,0.863788968825,0.159763313609,0.988474204171,0.261501210654,0.921934988482,338,1822,1801,21,284,54,0.858796296296,0.57411875889,0.57411875889
15,0,15,0.671875,0.858301526718,0.126470588235,0.988461538462,0.212871287129,0.918794688458,340,1820,1799,21,297,43,0.852777777778,0.557466063348,0.557466063348
15,0,16,0.623188405797,0.860832137733,0.12874251497,0.985761226725,0.213399503722,0.919070717386,334,1826,1800,26,291,43,0.853240740741,0.557251870848,0.557251870848
15,0,17,0.732394366197,0.863571086644,0.154302670623,0.989577619309,0.254901960784,0.922290388548,337,1823,1804,19,285,52,0.859259259259,0.571940144966,0.571940144966
15,0,18,0.68,0.865707434053,0.154078549849,0.986878075451,0.251231527094,0.922330097087,331,1829,1805,24,280,51,0.859259259259,0.57047831265,0.57047831265
15,0,19,0.679487179487,0.861671469741,0.155425219941,0.986256184717,0.252983293556,0.919764163035,341,1819,1794,25,288,53,0.855092592593,0.570840702329,0.570840702329
15,0,20,0.704225352113,0.85926280517,0.145348837209,0.988436123348,0.240963855422,0.91933418694,344,1816,1795,21,294,50,0.854166666667,0.566892480279,0.566892480279
15,0,21,0.670886075949,0.863527150408,0.157270029674,0.985737794844,0.254807692308,0.920594262295,337,1823,1797,26,284,53,0.856481481481,0.571503912259,0.571503912259
15,0,22,0.739726027397,0.857690464782,0.153846153846,0.989496959646,0.254716981132,0.918891170431,351,1809,1790,19,297,54,0.853703703704,0.571671556746,0.571671556746
15,0,23,0.732394366197,0.856869315462,0.148148148148,0.989496959646,0.24644549763,0.918419702411,351,1809,1790,19,299,52,0.852777777778,0.568822553897,0.568822553897
15,0,24,0.68,0.860431654676,0.149122807018,0.986798679868,0.244604316547,0.919292851653,342,1818,1794,24,291,51,0.854166666667,0.567960743443,0.567960743443
15,0,25,0.706666666667,0.863788968825,0.157270029674,0.987931980252,0.257281553398,0.921699078813,337,1823,1801,22,284,53,0.858333333333,0.572601004963,0.572601004963
15,0,26,0.728813559322,0.860066634936,0.127596439169,0.991223258365,0.217171717172,0.920998980632,337,1823,1807,16,294,43,0.856481481481,0.559409848767,0.559409848767
15,0,27,0.666666666667,0.859195402299,0.140350877193,0.986798679868,0.231884057971,0.918586789555,342,1818,1794,24,294,48,0.852777777778,0.56357477853,0.56357477853
15,0,28,0.761904761905,0.856938483548,0.137931034483,0.991721854305,0.233576642336,0.919416730622,348,1812,1797,15,300,48,0.854166666667,0.564826444394,0.564826444394
15,0,29,0.692307692308,0.861575178998,0.134328358209,0.98904109589,0.225,0.920918367347,335,1825,1805,20,290,45,0.856481481481,0.56168472705,0.56168472705
15,0,30,0.685714285714,0.855980861244,0.137535816619,0.987852015461,0.229116945107,0.917200717765,349,1811,1789,22,301,48,0.850462962963,0.56269391604,0.56269391604
15,0,31,0.647887323944,0.864049784586,0.139393939394,0.986338797814,0.229426433915,0.921153355448,330,1830,1805,25,284,46,0.856944444444,0.562866368604,0.562866368604
15,0,32,0.643835616438,0.861523718256,0.139880952381,0.985745614035,0.229828850856,0.919457939146,336,1824,1798,26,289,47,0.854166666667,0.562813283208,0.562813283208
15,0,33,0.72972972973,0.859060402685,0.155172413793,0.988962472406,0.255924170616,0.919445869677,348,1812,1792,20,294,54,0.85462962963,0.5720674431,0.5720674431
15,0,34,0.652777777778,0.860153256705,0.138643067847,0.986271279517,0.228710462287,0.918905090816,339,1821,1796,25,292,47,0.853240740741,0.562457173682,0.562457173682
15,0,35,0.69014084507,0.86213499282,0.145400593472,0.987931980252,0.240196078431,0.920756646217,337,1823,1801,22,288,49,0.856481481481,0.566666286862,0.566666286862
15,0,36,0.757142857143,0.862200956938,0.155425219941,0.990654205607,0.257907542579,0.92197492965,341,1819,1802,17,288,53,0.858796296296,0.573039712774,0.573039712774
15,0,37,0.705882352941,0.858030592734,0.139130434783,0.988980716253,0.232445520581,0.918863578193,345,1815,1795,20,297,48,0.853240740741,0.564055575518,0.564055575518
15,0,38,0.710526315789,0.86084452975,0.156976744186,0.987885462555,0.257142857143,0.92,344,1816,1794,22,290,54,0.855555555556,0.572431103371,0.572431103371
15,0,39,0.75,0.858986615679,0.147398843931,0.990628445424,0.246376811594,0.920122887865,346,1814,1797,17,295,51,0.855555555556,0.569013644678,0.569013644678
15,0,40,0.746268656716,0.859531772575,0.145348837209,0.99063876652,0.243309002433,0.920440010233,344,1816,1799,17,294,50,0.856018518519,0.567993801865,0.567993801865
15,0,41,0.760563380282,0.856869315462,0.152974504249,0.990592141671,0.254716981132,0.918891170431,353,1807,1790,17,299,54,0.853703703704,0.57178332296,0.57178332296
15,0,42,0.769230769231,0.859665871122,0.145348837209,0.991740088106,0.244498777506,0.920992073638,344,1816,1801,15,294,50,0.856944444444,0.568544462658,0.568544462658
15,0,43,0.705882352941,0.856596558317,0.137931034483,0.988962472406,0.230769230769,0.918032786885,348,1812,1792,20,300,48,0.851851851852,0.563446753444,0.563446753444
15,0,44,0.692307692308,0.859188544153,0.132352941176,0.989010989011,0.222222222222,0.919540229885,340,1820,1800,20,295,45,0.854166666667,0.560681965094,0.560681965094
15,0,45,0.793650793651,0.856938483548,0.142857142857,0.992817679558,0.242130750605,0.919887381623,350,1810,1797,13,300,50,0.855092592593,0.567837411208,0.567837411208
15,0,46,0.703125,0.859255725191,0.132352941176,0.98956043956,0.222772277228,0.919816138917,340,1820,1801,19,295,45,0.85462962963,0.560956690368,0.560956690368
15,0,47,0.71875,0.856870229008,0.132947976879,0.990077177508,0.224390243902,0.918670076726,346,1814,1796,18,300,46,0.852777777778,0.561512577193,0.561512577193
15,0,48,0.764705882353,0.864722753346,0.155223880597,0.991232876712,0.258064516129,0.923666070973,335,1825,1809,16,283,52,0.861574074074,0.573228378655,0.573228378655
15,0,49,0.710526315789,0.859404990403,0.155619596542,0.987865416437,0.255319148936,0.919168591224,347,1813,1791,22,293,54,0.854166666667,0.571742506489,0.571742506489
15,0,50,0.742424242424,0.85482330468,0.1388101983,0.990592141671,0.233890214797,0.917713406819,353,1807,1790,17,304,49,0.851388888889,0.564701169986,0.564701169986
15,0,51,0.767123287671,0.859607091519,0.160458452722,0.990612921038,0.265402843602,0.920472036942,349,1811,1794,17,293,56,0.856481481481,0.57553568688,0.57553568688
15,0,52,0.676470588235,0.86137667304,0.136904761905,0.987938596491,0.227722772277,0.920326864147,336,1824,1802,22,290,46,0.855555555556,0.562421679198,0.562421679198
15,0,53,0.761904761905,0.858845970434,0.139534883721,0.991740088106,0.235872235872,0.920521339126,344,1816,1801,15,296,48,0.856018518519,0.565637485913,0.565637485913
15,0,54,0.728571428571,0.857894736842,0.146551724138,0.989514348786,0.244019138756,0.919015889288,348,1812,1793,19,297,51,0.853703703704,0.568033036462,0.568033036462
15,0,55,0.680555555556,0.856800766284,0.140804597701,0.987306843267,0.233333333333,0.917435897436,348,1812,1789,23,299,49,0.850925925926,0.564055720484,0.564055720484
15,0,56,0.746478873239,0.860698898995,0.154069767442,0.990088105727,0.255421686747,0.920870678617,344,1816,1798,18,291,53,0.856944444444,0.572078936584,0.572078936584
15,0,57,0.676056338028,0.85639061752,0.137931034483,0.987306843267,0.229116945107,0.917200717765,348,1812,1789,23,300,48,0.850462962963,0.562618938875,0.562618938875
15,0,58,0.689189189189,0.865771812081,0.154078549849,0.987424822307,0.251851851852,0.922605363985,331,1829,1806,23,280,51,0.859722222222,0.570751686078,0.570751686078
15,0,59,0.732394366197,0.861177596936,0.152046783626,0.989548954895,0.25181598063,0.920911185052,342,1818,1799,19,290,52,0.856944444444,0.570797869261,0.570797869261
15,0,60,0.72602739726,0.860086248203,0.153623188406,0.988980716253,0.253588516746,0.920041004613,345,1815,1795,20,292,53,0.855555555556,0.57130195233,0.57130195233
15,0,61,0.693333333333,0.858033573141,0.149425287356,0.987306843267,0.245862884161,0.918142160636,348,1812,1789,23,296,52,0.852314814815,0.568366065312,0.568366065312
15,0,62,0.688311688312,0.865578492559,0.159159159159,0.986863711002,0.258536585366,0.922250639386,333,1827,1803,24,280,53,0.859259259259,0.57301143508,0.57301143508
15,0,63,0.757142857143,0.861244019139,0.154518950437,0.990643918547,0.256658595642,0.921423086767,343,1817,1800,17,290,53,0.85787037037,0.572581434492,0.572581434492
15,0,64,0.692307692308,0.860143198091,0.133136094675,0.989023051592,0.223325062035,0.920091907072,338,1822,1802,20,293,45,0.855092592593,0.561079573133,0.561079573133
15,0,65,0.741935483871,0.855576739752,0.131805157593,0.991165102154,0.223844282238,0.91839345101,349,1811,1795,16,303,46,0.852314814815,0.561485129873,0.561485129873
15,0,66,0.704225352113,0.862613690761,0.148367952522,0.988480526604,0.245098039216,0.921267893661,337,1823,1802,21,287,50,0.857407407407,0.568424239563,0.568424239563
15,0,67,0.712328767123,0.863919501677,0.154761904762,0.988486842105,0.254278728606,0.922014829967,336,1824,1803,21,284,52,0.858796296296,0.571624373434,0.571624373434
15,0,68,0.694444444444,0.858237547893,0.14450867052,0.987872105843,0.239234449761,0.918503331625,346,1814,1792,22,296,50,0.852777777778,0.566190388182,0.566190388182
15,0,69,0.666666666667,0.857484457198,0.133720930233,0.987334801762,0.222760290557,0.917839774763,344,1816,1793,23,298,46,0.851388888889,0.560527865997,0.560527865997
15,0,70,0.691176470588,0.85707456979,0.135838150289,0.98842337376,0.227053140097,0.918074756784,346,1814,1793,21,299,47,0.851851851852,0.562130762024,0.562130762024
15,0,71,0.736111111111,0.862068965517,0.155425219941,0.989554700385,0.256658595642,0.921423086767,341,1819,1800,19,288,53,0.85787037037,0.572489960163,0.572489960163
15,0,72,0.803278688525,0.859456884231,0.142441860465,0.993392070485,0.241975308642,0.921583652618,344,1816,1804,12,295,49,0.85787037037,0.567916965475,0.567916965475
15,0,73,0.764705882353,0.858508604207,0.149425287356,0.991169977925,0.25,0.920081967213,348,1812,1796,16,296,52,0.855555555556,0.570297632641,0.570297632641
15,0,74,0.685714285714,0.86028708134,0.141176470588,0.987912087912,0.234146341463,0.919693094629,340,1820,1798,22,292,48,0.85462962963,0.56454427925,0.56454427925
15,0,75,0.741935483871,0.859389895138,0.134897360704,0.991203958219,0.228287841191,0.920602501915,341,1819,1803,16,295,46,0.856018518519,0.563050659461,0.563050659461
15,0,76,0.742424242424,0.857688634193,0.14121037464,0.990623276338,0.237288135593,0.919375479908,347,1813,1796,17,298,49,0.854166666667,0.565916825489,0.565916825489
15,0,77,0.78125,0.860687022901,0.146198830409,0.992299229923,0.246305418719,0.921819110884,342,1818,1804,14,292,50,0.858333333333,0.569249030166,0.569249030166
15,0,78,0.75,0.861804222649,0.165217391304,0.989531680441,0.270783847981,0.921261862016,345,1815,1796,19,288,57,0.85787037037,0.577374535873,0.577374535873
15,0,79,0.684931506849,0.862482031624,0.148367952522,0.9873834339,0.243902439024,0.920716112532,337,1823,1800,23,287,50,0.856481481481,0.567875693211,0.567875693211
15,0,80,0.724637681159,0.858919177427,0.144927536232,0.989531680441,0.24154589372,0.919610855095,345,1815,1796,19,295,50,0.85462962963,0.567229608336,0.567229608336
15,0,81,0.675675675676,0.860498561841,0.146627565982,0.986805937328,0.240963855422,0.91933418694,341,1819,1795,24,291,50,0.854166666667,0.566716751655,0.566716751655
15,0,82,0.72,0.858992805755,0.155172413793,0.988410596026,0.255319148936,0.919168591224,348,1812,1791,21,294,54,0.854166666667,0.57179150491,0.57179150491
15,0,83,0.661764705882,0.856596558317,0.130434782609,0.987327823691,0.217917675545,0.917327873048,345,1815,1792,23,300,45,0.850462962963,0.55888130315,0.55888130315
15,0,84,0.757142857143,0.855023923445,0.148876404494,0.990576496674,0.24882629108,0.917822290704,356,1804,1787,17,303,53,0.851851851852,0.569726450584,0.569726450584
15,0,85,0.68,0.863788968825,0.15223880597,0.986849315068,0.248780487805,0.921227621483,335,1825,1801,24,284,51,0.857407407407,0.569544060519,0.569544060519
15,0,86,0.716216216216,0.86481303931,0.158208955224,0.988493150685,0.259168704156,0.922526208131,335,1825,1804,21,282,53,0.859722222222,0.573351052954,0.573351052954
15,0,87,0.736842105263,0.863723608445,0.164705882353,0.989010989011,0.269230769231,0.922131147541,340,1820,1800,20,284,56,0.859259259259,0.576858435682,0.576858435682
15,0,88,0.7,0.85980861244,0.143274853801,0.988448844884,0.23786407767,0.919651995906,342,1818,1797,21,293,49,0.85462962963,0.565861849343,0.565861849343
15,0,89,0.671052631579,0.8613243762,0.15,0.986263736264,0.245192307692,0.919569672131,340,1820,1795,25,289,51,0.85462962963,0.568131868132,0.568131868132
15,0,90,0.642857142857,0.86028708134,0.13353115727,0.986286341196,0.22113022113,0.918987988755,337,1823,1798,25,292,45,0.853240740741,0.559908749233,0.559908749233
15,0,91,0.722222222222,0.860632183908,0.151603498542,0.988992845349,0.250602409639,0.920358514725,343,1817,1797,20,291,52,0.856018518519,0.570298171946,0.570298171946
15,0,92,0.704225352113,0.860220201053,0.146198830409,0.988448844884,0.242130750605,0.919887381623,342,1818,1797,21,292,50,0.855092592593,0.567323837647,0.567323837647
15,0,93,0.793650793651,0.864568431092,0.149700598802,0.992880613363,0.251889168766,0.924292633189,334,1826,1813,13,284,50,0.8625,0.571290606082,0.571290606082
15,0,94,0.775862068966,0.856803044719,0.130057803468,0.992833517089,0.222772277228,0.919816138917,346,1814,1801,13,301,45,0.85462962963,0.561445660279,0.561445660279
15,0,95,0.628205128205,0.865033621518,0.148484848485,0.984153005464,0.240196078431,0.920756646217,330,1830,1801,29,281,49,0.856481481481,0.566318926975,0.566318926975
15,0,96,0.671052631579,0.86660268714,0.155015197568,0.986346258875,0.251851851852,0.922605363985,329,1831,1806,25,278,51,0.859722222222,0.570680728222,0.570680728222
15,0,97,0.666666666667,0.864357864358,0.160714285714,0.985197368421,0.258992805755,0.920830130669,336,1824,1797,27,282,54,0.856944444444,0.572955827068,0.572955827068
15,0,98,0.78125,0.860209923664,0.145772594752,0.992294991745,0.2457002457,0.921543572706,343,1817,1803,14,293,50,0.85787037037,0.569033793248,0.569033793248
15,0,99,0.742424242424,0.858643744031,0.142028985507,0.990633608815,0.238442822384,0.919928370427,345,1815,1798,17,296,49,0.855092592593,0.566331297161,0.566331297161
17,0,0,0.741379310345,0.854900095147,0.123563218391,0.991721854305,0.211822660099,0.91824220746,348,1812,1797,15,305,43,0.851851851852,0.557642536348,0.557642536348
17,0,1,0.650793650794,0.858845970434,0.121661721068,0.987931980252,0.205,0.91887755102,337,1823,1801,22,296,41,0.852777777778,0.55479685066,0.55479685066
17,0,2,0.676056338028,0.85926280517,0.140350877193,0.987348734873,0.232445520581,0.918863578193,342,1818,1795,23,294,48,0.853240740741,0.563849806033,0.563849806033
17,0,3,0.77358490566,0.862838158519,0.124242424242,0.993442622951,0.21409921671,0.923545847092,330,1830,1818,12,289,41,0.860648148148,0.558842523597,0.558842523597
17,0,4,0.677966101695,0.852451213708,0.114285714286,0.989502762431,0.195599022005,0.915878291997,350,1810,1791,19,310,40,0.847685185185,0.551894238358,0.551894238358
17,0,5,0.709677419355,0.854623450906,0.126074498567,0.990060739923,0.214111922141,0.917370171399,349,1811,1793,18,305,44,0.850462962963,0.558067619245,0.558067619245
17,0,6,0.625,0.858301526718,0.118694362018,0.986834887548,0.199501246883,0.918091349834,337,1823,1799,24,297,40,0.851388888889,0.552764624783,0.552764624783
17,0,7,0.734375,0.860687022901,0.138643067847,0.990664470071,0.233250620347,0.921113096758,339,1821,1804,17,292,47,0.856944444444,0.564653768959,0.564653768959
17,0,8,0.761904761905,0.858845970434,0.139534883721,0.991740088106,0.235872235872,0.920521339126,344,1816,1801,15,296,48,0.856018518519,0.565637485913,0.565637485913
17,0,9,0.603448275862,0.854900095147,0.102941176471,0.987362637363,0.175879396985,0.916369199388,340,1820,1797,23,305,35,0.848148148148,0.545151906917,0.545151906917
17,0,10,0.625,0.85775862069,0.131578947368,0.985148514851,0.217391304348,0.917050691244,342,1818,1791,27,297,45,0.85,0.55836373111,0.55836373111
17,0,11,0.693548387097,0.857483317445,0.125730994152,0.989548954895,0.212871287129,0.918794688458,342,1818,1799,19,299,43,0.852777777778,0.557639974524,0.557639974524
17,0,12,0.745098039216,0.853485064011,0.109510086455,0.992829564258,0.190954773869,0.917899031107,347,1813,1800,13,309,38,0.850925925926,0.551169825357,0.551169825357
17,0,13,0.719298245614,0.853067047076,0.117142857143,0.991160220994,0.201474201474,0.916943521595,350,1810,1794,16,309,41,0.849537037037,0.554151539069,0.554151539069
17,0,14,0.676470588235,0.859464627151,0.135294117647,0.987912087912,0.225490196078,0.919222903885,340,1820,1798,22,294,46,0.853703703704,0.56160310278,0.56160310278
17,0,15,0.771929824561,0.854969091774,0.126074498567,0.9928216455,0.216748768473,0.918753193664,349,1811,1798,13,305,44,0.852777777778,0.559448072034,0.559448072034
17,0,16,0.811320754717,0.854295206455,0.122857142857,0.994475138122,0.213399503722,0.919070717386,350,1810,1800,10,307,43,0.853240740741,0.558666140489,0.558666140489
17,0,17,0.731343283582,0.859531772575,0.142857142857,0.990093560815,0.239024390244,0.920204603581,343,1817,1799,18,294,49,0.855555555556,0.566475351836,0.566475351836
17,0,18,0.68253968254,0.858369098712,0.126470588235,0.989010989011,0.213399503722,0.919070717386,340,1820,1800,20,297,43,0.853240740741,0.557740788623,0.557740788623
17,0,19,0.709677419355,0.853193517636,0.125,0.990044247788,0.212560386473,0.916538658474,352,1808,1790,18,308,44,0.849074074074,0.557522123894,0.557522123894
17,0,20,0.709090909091,0.854156769596,0.112716763006,0.991179713341,0.194513715711,0.917581015565,346,1814,1798,16,307,39,0.850462962963,0.551948238173,0.551948238173
17,0,21,0.71186440678,0.855306996668,0.121387283237,0.990628445424,0.207407407407,0.918007662835,346,1814,1797,17,304,42,0.851388888889,0.556007864331,0.556007864331
17,0,22,0.6875,0.859255725191,0.129793510324,0.989017023613,0.218362282878,0.919581312229,339,1821,1801,20,295,44,0.854166666667,0.559405266969,0.559405266969
17,0,23,0.714285714286,0.851235741445,0.113314447592,0.991145545102,0.195599022005,0.915878291997,353,1807,1791,16,313,40,0.847685185185,0.552229996347,0.552229996347
17,0,24,0.671875,0.854484732824,0.123563218391,0.988410596026,0.208737864078,0.916581371546,348,1812,1791,21,305,43,0.849074074074,0.555986907209,0.555986907209
17,0,25,0.741379310345,0.858705994291,0.126470588235,0.991758241758,0.21608040201,0.920448750637,340,1820,1805,15,297,43,0.855555555556,0.559114414997,0.559114414997
17,0,26,0.758620689655,0.858230256898,0.12865497076,0.992299229923,0.22,0.920408163265,342,1818,1804,14,298,44,0.855555555556,0.560477100342,0.560477100342
17,0,27,0.767857142857,0.852661596958,0.121813031161,0.992805755396,0.210268948655,0.917412426489,353,1807,1794,13,310,43,0.850462962963,0.557309393279,0.557309393279
17,0,28,0.758064516129,0.856530028599,0.135057471264,0.991721854305,0.229268292683,0.919181585678,348,1812,1797,15,301,47,0.853703703704,0.563389662785,0.563389662785
17,0,29,0.75,0.859732824427,0.140350877193,0.991199119912,0.23645320197,0.920797138477,342,1818,1802,16,294,48,0.856481481481,0.565774998552,0.565774998552
17,0,30,0.655737704918,0.856121962839,0.116959064327,0.988448844884,0.198511166253,0.917538932857,342,1818,1797,21,302,40,0.850462962963,0.552703954606,0.552703954606
17,0,31,0.677966101695,0.855782960495,0.116618075802,0.989543203082,0.199004975124,0.917815211843,343,1817,1798,19,303,40,0.850925925926,0.553080639442,0.553080639442
17,0,32,0.693548387097,0.863203050524,0.130303030303,0.989617486339,0.219387755102,0.922097759674,330,1830,1811,19,287,43,0.858333333333,0.559960258321,0.559960258321
17,0,33,0.64406779661,0.856258924322,0.111764705882,0.988461538462,0.190476190476,0.917623055343,340,1820,1799,21,302,38,0.850462962963,0.550113122172,0.550113122172
17,0,34,0.619047619048,0.857892226991,0.115727002967,0.986834887548,0.195,0.917857142857,337,1823,1799,24,298,39,0.850925925926,0.551280945258,0.551280945258
17,0,35,0.741379310345,0.858705994291,0.126470588235,0.991758241758,0.21608040201,0.920448750637,340,1820,1805,15,297,43,0.855555555556,0.559114414997,0.559114414997
17,0,36,0.730158730159,0.858369098712,0.134110787172,0.990643918547,0.226600985222,0.919775166071,343,1817,1800,17,297,46,0.85462962963,0.56237735286,0.56237735286
17,0,37,0.719298245614,0.852591535901,0.116809116809,0.991155334439,0.200980392157,0.916666666667,351,1809,1793,16,310,41,0.849074074074,0.553982225624,0.553982225624
17,0,38,0.704918032787,0.854216293473,0.123209169054,0.990060739923,0.209756097561,0.917135549872,349,1811,1793,18,306,43,0.85,0.556634954489,0.556634954489
17,0,39,0.633333333333,0.854285714286,0.110465116279,0.987885462555,0.188118811881,0.916241062308,344,1816,1794,22,306,38,0.848148148148,0.549175289417,0.549175289417
17,0,40,0.75,0.855513307985,0.121387283237,0.992282249173,0.208955223881,0.918836140888,346,1814,1800,14,304,42,0.852777777778,0.556834766205,0.556834766205
17,0,41,0.71875,0.857824427481,0.133720930233,0.990088105727,0.225490196078,0.919222903885,344,1816,1798,18,298,46,0.853703703704,0.56190451798,0.56190451798
17,0,42,0.671428571429,0.85980861244,0.138235294118,0.987362637363,0.229268292683,0.919181585678,340,1820,1797,23,293,47,0.853703703704,0.56279896574,0.56279896574
17,0,43,0.65,0.854285714286,0.113043478261,0.988429752066,0.192592592593,0.916475095785,345,1815,1794,21,306,39,0.848611111111,0.550736615163,0.550736615163
17,0,44,0.676923076923,0.859188544153,0.129793510324,0.988467874794,0.217821782178,0.919305413687,339,1821,1800,21,295,44,0.853703703704,0.559130692559,0.559130692559
17,0,45,0.72131147541,0.85326345879,0.125,0.990597345133,0.213075060533,0.916815971334,352,1808,1791,17,308,44,0.849537037037,0.557798672566,0.557798672566
17,0,46,0.735849056604,0.854295206455,0.112716763006,0.992282249173,0.195488721805,0.918133129304,346,1814,1800,14,307,39,0.851388888889,0.552499506089,0.552499506089
17,0,47,0.75,0.85619047619,0.129682997118,0.991726420298,0.22113022113,0.918987988755,347,1813,1798,15,302,45,0.853240740741,0.560704708708,0.560704708708
17,0,48,0.704918032787,0.855645545498,0.124277456647,0.990077177508,0.211302211302,0.917965755175,346,1814,1796,18,303,43,0.851388888889,0.557177317078,0.557177317078
17,0,49,0.628571428571,0.856459330144,0.127906976744,0.985682819383,0.212560386473,0.916538658474,344,1816,1790,26,300,44,0.849074074074,0.556794898064,0.556794898064
17,0,50,0.698630136986,0.862961188309,0.151335311573,0.987931980252,0.248780487805,0.921227621483,337,1823,1801,22,286,51,0.857407407407,0.569633645913,0.569633645913
17,0,51,0.724137931034,0.851094196004,0.118309859155,0.991135734072,0.203389830508,0.915792167904,355,1805,1789,16,313,42,0.847685185185,0.554722796613,0.554722796613
17,0,52,0.732142857143,0.8536121673,0.117478510029,0.991717283269,0.202469135802,0.917496807152,349,1811,1796,15,308,41,0.850462962963,0.554597896649,0.554597896649
17,0,53,0.724137931034,0.856803044719,0.122448979592,0.99119427628,0.209476309227,0.919112018372,343,1817,1801,16,301,42,0.853240740741,0.556821627936,0.556821627936
17,0,54,0.734375,0.858778625954,0.137026239067,0.990643918547,0.230958230958,0.920010222336,343,1817,1800,17,296,47,0.855092592593,0.563835078807,0.563835078807
17,0,55,0.72131147541,0.857074797523,0.127906976744,0.99063876652,0.217283950617,0.919029374202,344,1816,1799,17,300,44,0.853240740741,0.559272871632,0.559272871632
17,0,56,0.78125,0.860209923664,0.145772594752,0.992294991745,0.2457002457,0.921543572706,343,1817,1803,14,293,50,0.85787037037,0.569033793248,0.569033793248
17,0,57,0.677419354839,0.860343183985,0.125373134328,0.98904109589,0.211586901763,0.920214121846,335,1825,1805,20,293,42,0.855092592593,0.557207115109,0.557207115109
17,0,58,0.742857142857,0.857894736842,0.14899713467,0.990060739923,0.248210023866,0.919251473981,349,1811,1793,18,297,52,0.854166666667,0.569528937297,0.569528937297
17,0,59,0.694915254237,0.857686815802,0.120588235294,0.99010989011,0.205513784461,0.919153277225,340,1820,1802,18,299,41,0.853240740741,0.555349062702,0.555349062702
17,0,60,0.71186440678,0.854355069015,0.120689655172,0.990618101545,0.206388206388,0.917454638385,348,1812,1795,17,306,42,0.850462962963,0.555653878359,0.555653878359
17,0,61,0.7,0.859330143541,0.142857142857,0.988442487617,0.237288135593,0.919375479908,343,1817,1796,21,294,49,0.854166666667,0.565649815237,0.565649815237
17,0,62,0.719298245614,0.853067047076,0.117142857143,0.991160220994,0.201474201474,0.916943521595,350,1810,1794,16,309,41,0.849537037037,0.554151539069,0.554151539069
17,0,63,0.686567164179,0.858098423316,0.134110787172,0.988442487617,0.224390243902,0.918670076726,343,1817,1796,21,297,46,0.852777777778,0.561276637394,0.561276637394
17,0,64,0.741379310345,0.856327307326,0.124637681159,0.99173553719,0.213399503722,0.919070717386,345,1815,1800,15,302,43,0.853240740741,0.558186609175,0.558186609175
17,0,65,0.696428571429,0.856939163498,0.114705882353,0.990659340659,0.19696969697,0.918960244648,340,1820,1803,17,301,39,0.852777777778,0.552682611506,0.552682611506
17,0,66,0.737704918033,0.854692710815,0.128571428571,0.991160220994,0.21897810219,0.917881811205,350,1810,1794,16,305,45,0.851388888889,0.559865824783,0.559865824783
17,0,67,0.705882352941,0.865200764818,0.145454545455,0.989071038251,0.241206030151,0.922998470168,330,1830,1810,20,282,48,0.860185185185,0.567262791853,0.567262791853
17,0,68,0.731343283582,0.863831820354,0.146706586826,0.990142387733,0.244389027431,0.922684358255,334,1826,1808,18,285,49,0.859722222222,0.56842448728,0.56842448728
17,0,69,0.645161290323,0.859389895138,0.119402985075,0.987945205479,0.201511335013,0.91919449401,335,1825,1803,22,295,40,0.853240740741,0.553674095277,0.553674095277
17,0,70,0.709677419355,0.859866539561,0.130177514793,0.990120746432,0.22,0.920408163265,338,1822,1804,18,294,44,0.855555555556,0.560149130613,0.560149130613
17,0,71,0.705882352941,0.858030592734,0.139130434783,0.988980716253,0.232445520581,0.918863578193,345,1815,1795,20,297,48,0.853240740741,0.564055575518,0.564055575518
17,0,72,0.692307692308,0.852028639618,0.12676056338,0.98891966759,0.214285714286,0.915384615385,355,1805,1785,20,310,45,0.847222222222,0.557840115485,0.557840115485
17,0,73,0.684210526316,0.850213980029,0.110169491525,0.990033222591,0.189781021898,0.914811972371,354,1806,1788,18,315,39,0.845833333333,0.550101357058,0.550101357058
17,0,74,0.693548387097,0.857959961868,0.126099706745,0.989554700385,0.213399503722,0.919070717386,341,1819,1800,19,298,43,0.853240740741,0.557827203565,0.557827203565
17,0,75,0.705882352941,0.858508604207,0.139534883721,0.988986784141,0.233009708738,0.919140225179,344,1816,1796,20,296,48,0.853703703704,0.564260833931,0.564260833931
17,0,76,0.696428571429,0.855038022814,0.113372093023,0.99063876652,0.195,0.917857142857,344,1816,1799,17,305,39,0.850925925926,0.552005429772,0.552005429772
17,0,77,0.698412698413,0.856938483548,0.127906976744,0.989537444934,0.216216216216,0.918476871965,344,1816,1797,19,300,44,0.852314814815,0.558722210839,0.558722210839
17,0,78,0.68115942029,0.857484457198,0.136231884058,0.987878787879,0.227053140097,0.918074756784,345,1815,1793,22,298,47,0.851851851852,0.562055335968,0.562055335968
17,0,79,0.746268656716,0.861442904921,0.147058823529,0.990659340659,0.2457002457,0.921543572706,340,1820,1803,17,290,50,0.85787037037,0.568859082094,0.568859082094
17,0,80,0.671641791045,0.856665074056,0.130434782609,0.987878787879,0.218446601942,0.917604912999,345,1815,1793,22,300,45,0.850925925926,0.559156785244,0.559156785244
17,0,81,0.769230769231,0.858159392789,0.117994100295,0.993410214168,0.204603580563,0.920844998727,339,1821,1809,12,299,40,0.856018518519,0.555702157232,0.555702157232
17,0,82,0.775862068966,0.855851569933,0.129310344828,0.992825607064,0.221674876847,0.919264179867,348,1812,1799,13,303,45,0.853703703704,0.561067975946,0.561067975946
17,0,83,0.763636363636,0.863182897862,0.127272727273,0.992896174863,0.218181818182,0.923506988564,330,1830,1817,13,288,42,0.860648148148,0.560084451068,0.560084451068
17,0,84,0.701754385965,0.854018069425,0.115273775216,0.990623276338,0.19801980198,0.917262512768,347,1813,1796,17,307,40,0.85,0.552948525777,0.552948525777
17,0,85,0.762711864407,0.856258924322,0.129682997118,0.992277992278,0.221674876847,0.919264179867,347,1813,1799,14,302,45,0.853703703704,0.560980494698,0.560980494698
17,0,86,0.666666666667,0.861031518625,0.131343283582,0.987945205479,0.219451371571,0.92013268691,335,1825,1803,22,291,44,0.855092592593,0.559644244531,0.559644244531
17,0,87,0.7,0.860952380952,0.125748502994,0.990142387733,0.213197969543,0.921039225675,334,1826,1808,18,292,42,0.856481481481,0.557945445363,0.557945445363
17,0,88,0.705882352941,0.859464627151,0.140350877193,0.98899889989,0.234146341463,0.919693094629,342,1818,1798,20,294,48,0.85462962963,0.564674888541,0.564674888541
17,0,89,0.762711864407,0.858162779629,0.131195335277,0.992294991745,0.223880597015,0.920367534456,343,1817,1803,14,298,45,0.855555555556,0.561745163511,0.561745163511
17,0,90,0.754716981132,0.860465116279,0.119760479042,0.992880613363,0.206718346253,0.921942537503,334,1826,1813,13,294,40,0.85787037037,0.556320546202,0.556320546202
17,0,91,0.666666666667,0.856938483548,0.122807017544,0.988448844884,0.207407407407,0.918007662835,342,1818,1797,21,300,42,0.851388888889,0.555627931214,0.555627931214
17,0,92,0.627118644068,0.859590671109,0.111445783133,0.987964989059,0.18925831202,0.919317892594,332,1828,1806,22,295,37,0.853240740741,0.549705386096,0.549705386096
17,0,93,0.672131147541,0.859456884231,0.122023809524,0.989035087719,0.206549118388,0.919704307928,336,1824,1804,20,295,41,0.854166666667,0.555529448622,0.555529448622
17,0,94,0.698113207547,0.854295206455,0.107558139535,0.991189427313,0.186397984887,0.917665052256,344,1816,1800,16,307,37,0.850462962963,0.549373783424,0.549373783424
17,0,95,0.728813559322,0.858162779629,0.126099706745,0.991203958219,0.215,0.919897959184,341,1819,1803,16,298,43,0.85462962963,0.558651832482,0.558651832482
17,0,96,0.661538461538,0.86062052506,0.128358208955,0.987945205479,0.215,0.919897959184,335,1825,1803,22,292,43,0.85462962963,0.558151707217,0.558151707217
17,0,97,0.650793650794,0.856461611826,0.119883040936,0.987898789879,0.202469135802,0.917496807152,342,1818,1796,22,301,41,0.850462962963,0.553890915407,0.553890915407
17,0,98,0.720588235294,0.860420650096,0.143695014663,0.989554700385,0.239608801956,0.920480695474,341,1819,1800,19,292,49,0.856018518519,0.566624857524,0.566624857524
17,0,99,0.691176470588,0.856596558317,0.135446685879,0.988416988417,0.226506024096,0.917797695262,347,1813,1792,21,300,47,0.851388888889,0.561931837148,0.561931837148
19,0,0,0.661538461538,0.860143198091,0.127976190476,0.987938596491,0.214463840399,0.919622352641,336,1824,1802,22,293,43,0.854166666667,0.557957393484,0.557957393484
19,0,1,0.795918367347,0.855518711511,0.113372093023,0.99449339207,0.198473282443,0.919786096257,344,1816,1806,10,305,39,0.854166666667,0.553932742547,0.553932742547
19,0,2,0.684210526316,0.857822158821,0.115384615385,0.990120746432,0.19746835443,0.91923566879,338,1822,1804,18,299,39,0.853240740741,0.552752680909,0.552752680909
19,0,3,0.736842105263,0.855444602948,0.121387283237,0.991730981257,0.208436724566,0.918560122543,346,1814,1799,15,304,42,0.852314814815,0.556559132247,0.556559132247
19,0,4,0.666666666667,0.85619047619,0.116959064327,0.98899889989,0.199004975124,0.917815211843,342,1818,1798,20,302,40,0.850925925926,0.552978982109,0.552978982109
19,0,5,0.745454545455,0.856057007126,0.119186046512,0.992290748899,0.205513784461,0.919153277225,344,1816,1802,14,303,41,0.853240740741,0.555738397705,0.555738397705
19,0,6,0.783333333333,0.856666666667,0.135057471264,0.992825607064,0.230392156863,0.919734151329,348,1812,1799,13,301,47,0.85462962963,0.563941539164,0.563941539164
19,0,7,0.711538461538,0.854838709677,0.107871720117,0.991744634012,0.187341772152,0.91821656051,343,1817,1802,15,306,37,0.851388888889,0.549808177064,0.549808177064
19,0,8,0.701754385965,0.864479315264,0.123076923077,0.990735694823,0.20942408377,0.923311325546,325,1835,1818,17,285,40,0.860185185185,0.55690630895,0.55690630895
19,0,9,0.775862068966,0.86013320647,0.132743362832,0.992861065349,0.226700251889,0.921743563599,339,1821,1808,13,294,45,0.85787037037,0.56280221409,0.56280221409
19,0,10,0.701754385965,0.854018069425,0.115273775216,0.990623276338,0.19801980198,0.917262512768,347,1813,1796,17,307,40,0.85,0.552948525777,0.552948525777
19,0,11,0.75,0.852941176471,0.111747851003,0.9928216455,0.194513715711,0.917581015565,349,1811,1798,13,310,39,0.850462962963,0.552284748251,0.552284748251
19,0,12,0.762711864407,0.859114707282,0.131964809384,0.992303463441,0.225,0.920918367347,341,1819,1805,14,296,45,0.856481481481,0.562134136413,0.562134136413
19,0,13,0.745454545455,0.853206650831,0.117142857143,0.99226519337,0.202469135802,0.917496807152,350,1810,1796,14,309,41,0.850462962963,0.554704025257,0.554704025257
19,0,14,0.732142857143,0.8536121673,0.117478510029,0.991717283269,0.202469135802,0.917496807152,349,1811,1796,15,308,41,0.850462962963,0.554597896649,0.554597896649
19,0,15,0.781818181818,0.859382422803,0.126843657817,0.993410214168,0.218274111675,0.921548650025,339,1821,1809,12,296,43,0.857407407407,0.560126935993,0.560126935993
19,0,16,0.84,0.855924170616,0.121387283237,0.99558985667,0.212121212121,0.920489296636,346,1814,1806,8,304,42,0.855555555556,0.558488569954,0.558488569954
19,0,17,0.727272727273,0.853206650831,0.114613180516,0.991717283269,0.19801980198,0.917262512768,349,1811,1796,15,309,40,0.85,0.553165231892,0.553165231892
19,0,18,0.7,0.856666666667,0.122448979592,0.990093560815,0.208436724566,0.918560122543,343,1817,1799,18,301,42,0.852314814815,0.556271270203,0.556271270203
19,0,19,0.765957446809,0.854708944628,0.104956268222,0.993946064942,0.184615384615,0.919083969466,343,1817,1806,11,307,36,0.852777777778,0.549451166582,0.549451166582
19,0,20,0.706896551724,0.853472882969,0.117478510029,0.990612921038,0.201474201474,0.916943521595,349,1811,1794,17,308,41,0.849537037037,0.554045715533,0.554045715533
19,0,21,0.693548387097,0.858436606292,0.126470588235,0.98956043956,0.213930348259,0.919346605411,340,1820,1801,19,297,43,0.853703703704,0.558015513898,0.558015513898
19,0,22,0.759259259259,0.854700854701,0.118155619597,0.992829564258,0.204488778055,0.918601684103,347,1813,1800,13,306,41,0.852314814815,0.555492591927,0.555492591927
19,0,23,0.771929824561,0.855444602948,0.126436781609,0.992825607064,0.217283950617,0.919029374202,348,1812,1799,13,304,44,0.853240740741,0.559631194337,0.559631194337
19,0,24,0.640625,0.862118320611,0.124242424242,0.987431693989,0.208121827411,0.920529801325,330,1830,1807,23,289,41,0.855555555556,0.555837059116,0.555837059116
19,0,25,0.792452830189,0.855244423351,0.121037463977,0.993932708218,0.21,0.919387755102,347,1813,1802,11,305,42,0.853703703704,0.557485086098,0.557485086098
19,0,26,0.651515151515,0.855300859599,0.124277456647,0.987320837927,0.208737864078,0.916581371546,346,1814,1791,23,303,43,0.849074074074,0.555799147287,0.555799147287
19,0,27,0.758064516129,0.856530028599,0.135057471264,0.991721854305,0.229268292683,0.919181585678,348,1812,1797,15,301,47,0.853703703704,0.563389662785,0.563389662785
19,0,28,0.681818181818,0.857688634193,0.131195335277,0.988442487617,0.220048899756,0.918435182818,343,1817,1796,21,298,45,0.852314814815,0.559818911447,0.559818911447
19,0,29,0.762711864407,0.854831032842,0.128571428571,0.99226519337,0.220048899756,0.918435182818,350,1810,1796,14,305,45,0.852314814815,0.560418310971,0.560418310971
19,0,30,0.75,0.859315589354,0.12426035503,0.992316136114,0.213197969543,0.921039225675,338,1822,1808,14,296,42,0.856481481481,0.558288245572,0.558288245572
19,0,31,0.728813559322,0.854355069015,0.123209169054,0.991165102154,0.210784313725,0.917689161554,349,1811,1795,16,306,43,0.850925925926,0.557187135604,0.557187135604
19,0,32,0.686274509804,0.853010905642,0.101449275362,0.991184573003,0.176767676768,0.916921508665,345,1815,1799,16,310,35,0.849074074074,0.546316924183,0.546316924183
19,0,33,0.736842105263,0.856871136472,0.122448979592,0.991744634012,0.21,0.919387755102,343,1817,1802,15,301,42,0.853703703704,0.557096806802,0.557096806802
19,0,34,0.733333333333,0.857619047619,0.128279883382,0.99119427628,0.218362282878,0.919581312229,343,1817,1801,16,299,44,0.854166666667,0.559737079831,0.559737079831
19,0,35,0.6875,0.858778625954,0.129411764706,0.989010989011,0.217821782178,0.919305413687,340,1820,1800,20,296,44,0.853703703704,0.559211376858,0.559211376858
19,0,36,0.744680851064,0.858021769995,0.10447761194,0.993424657534,0.183246073298,0.920771965465,335,1825,1813,12,300,35,0.855555555556,0.548951134737,0.548951134737
19,0,37,0.766666666667,0.854761904762,0.131054131054,0.992260917634,0.223844282238,0.91839345101,351,1809,1795,14,305,46,0.852314814815,0.561657524344,0.561657524344
19,0,38,0.759259259259,0.856125356125,0.119186046512,0.992841409692,0.206030150754,0.919428862825,344,1816,1803,13,303,41,0.853703703704,0.556013728102,0.556013728102
19,0,39,0.685185185185,0.85232668566,0.10632183908,0.990618101545,0.18407960199,0.916283818275,348,1812,1795,17,311,37,0.848148148148,0.548469970313,0.548469970313
19,0,40,0.730158730159,0.858845970434,0.134502923977,0.990649064906,0.227160493827,0.920051085568,342,1818,1801,17,296,46,0.855092592593,0.562575994442,0.562575994442
19,0,41,0.80701754386,0.859248692344,0.134502923977,0.993949394939,0.230576441103,0.921703647029,342,1818,1807,11,296,46,0.85787037037,0.564226159458,0.564226159458
19,0,42,0.75,0.855513307985,0.121387283237,0.992282249173,0.208955223881,0.918836140888,346,1814,1800,14,304,42,0.852777777778,0.556834766205,0.556834766205
19,0,43,0.771929824561,0.855444602948,0.126436781609,0.992825607064,0.217283950617,0.919029374202,348,1812,1799,13,304,44,0.853240740741,0.559631194337,0.559631194337
19,0,44,0.741379310345,0.859181731684,0.126843657817,0.99176276771,0.216624685139,0.920723935763,339,1821,1806,15,296,43,0.856018518519,0.559303212764,0.559303212764
19,0,45,0.666666666667,0.856461611826,0.122448979592,0.988442487617,0.206896551724,0.917731221257,343,1817,1796,21,301,42,0.850925925926,0.555445733604,0.555445733604
19,0,46,0.68,0.854976303318,0.1,0.991208791209,0.174358974359,0.918066157761,340,1820,1804,16,306,34,0.850925925926,0.545604395604,0.545604395604
19,0,47,0.736842105263,0.857822158821,0.123167155425,0.99175371083,0.211055276382,0.919938806731,341,1819,1804,15,299,42,0.85462962963,0.557460433128,0.557460433128
19,0,48,0.716417910448,0.859053989489,0.139941690962,0.989543203082,0.234146341463,0.919693094629,343,1817,1798,19,295,48,0.85462962963,0.564742447022,0.564742447022
19,0,49,0.741379310345,0.861560418649,0.12874251497,0.991785323111,0.219387755102,0.922097759674,334,1826,1811,15,291,43,0.858333333333,0.56026391904,0.56026391904
19,0,50,0.728813559322,0.856734888149,0.125,0.991189427313,0.213399503722,0.919070717386,344,1816,1800,16,301,43,0.853240740741,0.558094713656,0.558094713656
19,0,51,0.75,0.857824427481,0.138728323699,0.991179713341,0.234146341463,0.919693094629,346,1814,1798,16,298,48,0.85462962963,0.56495401852,0.56495401852
19,0,52,0.711538461538,0.856736242884,0.109144542773,0.99176276771,0.18925831202,0.919317892594,339,1821,1806,15,302,37,0.853240740741,0.550453655241,0.550453655241
19,0,53,0.769230769231,0.851043643264,0.112994350282,0.993355481728,0.197044334975,0.91670924885,354,1806,1794,12,314,40,0.849074074074,0.553174916005,0.553174916005
19,0,54,0.738461538462,0.858711217184,0.139534883721,0.99063876652,0.234718826406,0.91996931731,344,1816,1799,17,296,48,0.855092592593,0.56508682512,0.56508682512
19,0,55,0.733333333333,0.858095238095,0.12865497076,0.991199119912,0.218905472637,0.919857069934,342,1818,1802,16,298,44,0.85462962963,0.559927045336,0.559927045336
19,0,56,0.722222222222,0.855175688509,0.113372093023,0.991740088106,0.195979899497,0.918408975013,344,1816,1801,15,305,39,0.851851851852,0.552556090564,0.552556090564
19,0,57,0.733333333333,0.85380952381,0.125356125356,0.991155334439,0.214111922141,0.917370171399,351,1809,1793,16,307,44,0.850462962963,0.558255729898,0.558255729898
19,0,58,0.686567164179,0.858098423316,0.134110787172,0.988442487617,0.224390243902,0.918670076726,343,1817,1796,21,297,46,0.852777777778,0.561276637394,0.561276637394
19,0,59,0.666666666667,0.856461611826,0.122448979592,0.988442487617,0.206896551724,0.917731221257,343,1817,1796,21,301,42,0.850925925926,0.555445733604,0.555445733604
19,0,60,0.732142857143,0.855988593156,0.119186046512,0.991740088106,0.205,0.91887755102,344,1816,1801,15,303,41,0.852777777778,0.555463067309,0.555463067309
19,0,61,0.746031746032,0.861230329041,0.139053254438,0.991218441273,0.234413965087,0.921663689717,338,1822,1806,16,291,47,0.85787037037,0.565135847856,0.565135847856
19,0,62,0.683333333333,0.859047619048,0.121661721068,0.989577619309,0.206549118388,0.919704307928,337,1823,1804,19,296,41,0.854166666667,0.555619670189,0.555619670189
19,0,63,0.759259259259,0.852801519468,0.116809116809,0.992813709232,0.202469135802,0.917496807152,351,1809,1796,13,310,41,0.850462962963,0.55481141302,0.55481141302
19,0,64,0.736842105263,0.854969091774,0.121037463977,0.991726420298,0.207920792079,0.918283963228,347,1813,1798,15,305,42,0.851851851852,0.556381942137,0.556381942137
19,0,65,0.745762711864,0.863398381723,0.132930513595,0.991798797157,0.225641025641,0.923155216285,331,1829,1814,15,287,44,0.860185185185,0.562364655376,0.562364655376
19,0,66,0.78,0.854502369668,0.112716763006,0.993936052922,0.19696969697,0.918960244648,346,1814,1803,11,307,39,0.852777777778,0.553326407964,0.553326407964
19,0,67,0.740740740741,0.856600189934,0.116959064327,0.992299229923,0.20202020202,0.919469928644,342,1818,1804,14,302,40,0.853703703704,0.554629147125,0.554629147125
19,0,68,0.722222222222,0.859449192783,0.116417910448,0.991780821918,0.200514138817,0.920885270923,335,1825,1810,15,296,39,0.856018518519,0.554099366183,0.554099366183
19,0,69,0.741379310345,0.861084681256,0.128358208955,0.991780821918,0.218829516539,0.921823274764,335,1825,1810,15,292,43,0.85787037037,0.560069515437,0.560069515437
19,0,70,0.769230769231,0.859582542694,0.119047619048,0.993421052632,0.20618556701,0.921668362157,336,1824,1812,12,296,40,0.857407407407,0.55623433584,0.55623433584
19,0,71,0.758620689655,0.855851569933,0.126801152738,0.992277992278,0.217283950617,0.919029374202,347,1813,1799,14,303,44,0.853240740741,0.559539572508,0.559539572508
19,0,72,0.770833333333,0.854166666667,0.107246376812,0.993939393939,0.188295165394,0.918767507003,345,1815,1804,11,308,37,0.852314814815,0.550592885375,0.550592885375
19,0,73,0.650793650794,0.861707200763,0.123867069486,0.987971569163,0.208121827411,0.920529801325,331,1829,1807,22,290,41,0.855555555556,0.555919319325,0.555919319325
19,0,74,0.730769230769,0.853889943074,0.109826589595,0.992282249173,0.190954773869,0.917899031107,346,1814,1800,14,308,38,0.850925925926,0.551054419384,0.551054419384
19,0,75,0.763636363636,0.847980997625,0.116022099448,0.99276974416,0.201438848921,0.914681014604,362,1798,1785,13,320,42,0.845833333333,0.554395921804,0.554395921804
19,0,76,0.728813559322,0.856734888149,0.125,0.991189427313,0.213399503722,0.919070717386,344,1816,1800,16,301,43,0.853240740741,0.558094713656,0.558094713656
19,0,77,0.68253968254,0.858845970434,0.126843657817,0.989017023613,0.213930348259,0.919346605411,339,1821,1801,20,296,43,0.853703703704,0.557930340715,0.557930340715
19,0,78,0.72131147541,0.862791805622,0.132530120482,0.990700218818,0.223918575064,0.922332569391,332,1828,1811,17,288,44,0.858796296296,0.56161516965,0.56161516965
19,0,79,0.72131147541,0.854692710815,0.126074498567,0.990612921038,0.214634146341,0.917647058824,349,1811,1794,17,305,44,0.850925925926,0.558343709803,0.558343709803
19,0,80,0.693548387097,0.859389895138,0.127218934911,0.989571899012,0.215,0.919897959184,338,1822,1803,19,295,43,0.85462962963,0.558395416962,0.558395416962
19,0,81,0.826923076923,0.857210626186,0.125,0.995044052863,0.217171717172,0.920998980632,344,1816,1807,9,301,43,0.856481481481,0.560022026432,0.560022026432
19,0,82,0.694915254237,0.862922417896,0.12462006079,0.99016930639,0.211340206186,0.922177009156,329,1831,1813,18,288,41,0.858333333333,0.55739468359,0.55739468359
19,0,83,0.706896551724,0.856803044719,0.119883040936,0.990649064906,0.205,0.91887755102,342,1818,1801,17,301,41,0.852777777778,0.555266052921,0.555266052921
19,0,84,0.716666666667,0.854761904762,0.123563218391,0.990618101545,0.210784313725,0.917689161554,348,1812,1795,17,305,43,0.850925925926,0.557090659968,0.557090659968
19,0,85,0.741935483871,0.858436606292,0.134110787172,0.99119427628,0.227160493827,0.920051085568,343,1817,1801,16,297,46,0.855092592593,0.562652531726,0.562652531726
19,0,86,0.766666666667,0.855714285714,0.131805157593,0.992269464384,0.224938875306,0.918946560982,349,1811,1797,14,303,46,0.853240740741,0.562037310989,0.562037310989
19,0,87,0.777777777778,0.859322842155,0.142441860465,0.992290748899,0.240786240786,0.921032455916,344,1816,1802,14,295,49,0.856944444444,0.567366304682,0.567366304682
19,0,88,0.754098360656,0.860886136255,0.136094674556,0.991767288694,0.230576441103,0.921703647029,338,1822,1807,15,292,46,0.85787037037,0.563930981625,0.563930981625
19,0,89,0.741935483871,0.861296472831,0.13649851632,0.991223258365,0.230576441103,0.921703647029,337,1823,1807,16,291,46,0.85787037037,0.563860887343,0.563860887343
19,0,90,0.78,0.854976303318,0.113043478261,0.993939393939,0.19746835443,0.91923566879,345,1815,1804,11,306,39,0.853240740741,0.5534914361,0.5534914361
19,0,91,0.80701754386,0.85877318117,0.134110787172,0.993946064942,0.23,0.921428571429,343,1817,1806,11,297,46,0.857407407407,0.564028426057,0.564028426057
19,0,92,0.733333333333,0.854285714286,0.125714285714,0.991160220994,0.214634146341,0.917647058824,350,1810,1794,16,306,44,0.850925925926,0.558437253354,0.558437253354
19,0,93,0.709090909091,0.860332541568,0.117117117117,0.991242474001,0.201030927835,0.921159715158,333,1827,1811,16,294,39,0.856481481481,0.554179795559,0.554179795559
19,0,94,0.688524590164,0.862791805622,0.127272727273,0.989617486339,0.214833759591,0.921863069483,330,1830,1811,19,288,42,0.85787037037,0.558445106806,0.558445106806
19,0,95,0.783333333333,0.858095238095,0.136231884058,0.992837465565,0.232098765432,0.920561941252,345,1815,1802,13,298,47,0.856018518519,0.564534674811,0.564534674811
19,0,96,0.71186440678,0.856258924322,0.122093023256,0.99063876652,0.208436724566,0.918560122543,344,1816,1799,17,302,42,0.852314814815,0.556365894888,0.556365894888
19,0,97,0.728813559322,0.862922417896,0.129909365559,0.991252050301,0.220512820513,0.922646310433,331,1829,1813,16,288,43,0.859259259259,0.56058070793,0.56058070793
19,0,98,0.736842105263,0.855920114123,0.121739130435,0.99173553719,0.208955223881,0.918836140888,345,1815,1800,15,303,42,0.852777777778,0.556737333812,0.556737333812
19,0,99,0.65671641791,0.856665074056,0.127906976744,0.987334801762,0.214111922141,0.917370171399,344,1816,1793,23,300,44,0.850462962963,0.557620889253,0.557620889253
