K,Balanced,#Exec,PPV_S,PPV_NS,TPR_S,TPR_NS,F1_S,F1_NS,SUP_S,SUP_NS,TN,FP,FN,TP,Acc,AUC0,AUC1
3,1,0,0.5889423076923077,0.6358208955223881,0.667574931880109,0.5546875,0.6257982120051085,0.5924895688456189,367,384,213,171,122,245,0.6098535286284953,0.6111312159400545,0.6111312159400546
3,1,1,0.6132315521628499,0.6452513966480447,0.654891304347826,0.6031331592689295,0.633377135348226,0.6234817813765182,368,383,231,152,127,241,0.6284953395472703,0.6290122318083778,0.6290122318083778
3,1,2,0.5754716981132075,0.5963302752293578,0.648936170212766,0.52,0.6099999999999999,0.5555555555555556,376,375,195,180,132,244,0.5845539280958721,0.584468085106383,0.584468085106383
3,1,3,0.6109725685785536,0.6171428571428571,0.6464379947229552,0.5806451612903226,0.6282051282051283,0.5983379501385042,379,372,216,156,134,245,0.6138482023968043,0.6135415780066389,0.6135415780066388
3,1,4,0.5932642487046632,0.6246575342465753,0.6256830601092896,0.5922077922077922,0.6090425531914894,0.608,366,385,228,157,137,229,0.6085219707057257,0.6089454261585409,0.6089454261585409
3,1,5,0.6024691358024692,0.6473988439306358,0.6666666666666666,0.5818181818181818,0.6329442282749675,0.612859097127223,366,385,224,161,122,244,0.6231691078561917,0.6242424242424242,0.6242424242424243
3,1,6,0.6004672897196262,0.6377708978328174,0.6871657754010695,0.5464190981432361,0.6408977556109726,0.5885714285714285,374,377,206,171,117,257,0.6165113182423435,0.6167924367721528,0.6167924367721528
3,1,7,0.6274509803921569,0.6472303206997084,0.6790450928381963,0.5935828877005348,0.6522292993630574,0.6192468619246861,377,374,222,152,121,256,0.6364846870838882,0.6363139902693654,0.6363139902693656
3,1,8,0.6135831381733021,0.6450617283950617,0.6949602122015915,0.5588235294117647,0.6517412935323382,0.5988538681948423,377,374,209,165,115,262,0.6271637816245007,0.6268918708066781,0.6268918708066781
3,1,9,0.5960591133004927,0.6057971014492753,0.6402116402116402,0.5603217158176944,0.6173469387755103,0.5821727019498608,378,373,209,164,136,242,0.6005326231691078,0.6002666780146673,0.6002666780146674
3,1,10,0.6139088729016786,0.6407185628742516,0.6808510638297872,0.5706666666666667,0.6456494325346784,0.6036671368124119,376,375,214,161,120,256,0.625832223701731,0.6257588652482269,0.6257588652482269
3,1,11,0.6059850374064838,0.6428571428571429,0.6603260869565217,0.587467362924282,0.6319895968790636,0.6139154160982265,368,383,225,158,125,243,0.6231691078561917,0.6238967249404018,0.6238967249404018
3,1,12,0.6109725685785536,0.6142857142857143,0.6447368421052632,0.5795148247978437,0.6274007682458388,0.5963938973647712,380,371,215,156,135,245,0.6125166444740346,0.6121258334515535,0.6121258334515534
3,1,13,0.6089108910891089,0.6397694524495677,0.6630727762803235,0.5842105263157895,0.6348387096774194,0.610729023383769,371,380,222,158,125,246,0.6231691078561917,0.6236416512980565,0.6236416512980565
3,1,14,0.625,0.6656716417910448,0.6989247311827957,0.5883905013192612,0.6598984771573605,0.6246498599439775,372,379,223,156,112,260,0.6431424766977364,0.6436576162510285,0.6436576162510285
3,1,15,0.6256544502617801,0.6449864498644986,0.6459459459459459,0.6246719160104987,0.6356382978723404,0.6346666666666667,370,381,238,143,131,239,0.6351531291611185,0.6353089309782224,0.6353089309782224
3,1,16,0.5909090909090909,0.6126126126126126,0.6569148936170213,0.544,0.6221662468513854,0.576271186440678,376,375,204,171,129,247,0.6005326231691078,0.6004574468085107,0.6004574468085107
3,1,17,0.6186868686868687,0.6169014084507042,0.6430446194225722,0.5918918918918918,0.6306306306306306,0.6041379310344827,381,370,219,151,136,245,0.6178428761651131,0.617468255657232,0.617468255657232
3,1,18,0.5931372549019608,0.6122448979591837,0.6453333333333333,0.5585106382978723,0.6181353767560663,0.5841446453407511,375,376,210,166,133,242,0.6018641810918774,0.6019219858156029,0.6019219858156029
3,1,19,0.6069767441860465,0.6230529595015576,0.6832460732984293,0.5420054200542005,0.6428571428571429,0.5797101449275363,382,369,200,169,121,261,0.6138482023968043,0.612625746676315,0.612625746676315
3,1,20,0.610705596107056,0.6058823529411764,0.6519480519480519,0.5628415300546448,0.6306532663316583,0.58356940509915,385,366,206,160,134,251,0.6085219707057257,0.6073947910013484,0.6073947910013484
3,1,21,0.6073059360730594,0.6421725239616614,0.7037037037037037,0.5388739946380697,0.6519607843137256,0.5860058309037902,378,373,201,172,112,266,0.6218375499334221,0.6212888491708868,0.6212888491708867
3,1,22,0.5893719806763285,0.629080118694362,0.6612466124661247,0.5549738219895288,0.6232439335887612,0.5897079276773296,369,382,212,170,125,244,0.607190412782956,0.6081102172278268,0.6081102172278268
3,1,23,0.5911330049261084,0.6115942028985507,0.6417112299465241,0.5596816976127321,0.6153846153846154,0.5844875346260386,374,377,211,166,134,240,0.6005326231691078,0.600696463779628,0.600696463779628
3,1,24,0.6220095693779905,0.6216216216216216,0.6735751295336787,0.5671232876712329,0.6467661691542288,0.5931232091690544,386,365,207,158,126,260,0.6218375499334221,0.6203492086024558,0.6203492086024557
3,1,25,0.6013986013986014,0.6273291925465838,0.6825396825396826,0.5415549597855228,0.6394052044609665,0.5812949640287769,378,373,202,171,120,258,0.6125166444740346,0.6120473211626026,0.6120473211626026
3,1,26,0.6421052631578947,0.633423180592992,0.6421052631578947,0.633423180592992,0.6421052631578947,0.633423180592992,380,371,235,136,136,244,0.6378162450066578,0.6377642218754433,0.6377642218754433
3,1,27,0.6055276381909548,0.5949008498583569,0.6276041666666666,0.5722070844686649,0.6163682864450128,0.5833333333333334,384,367,210,157,143,241,0.6005326231691078,0.5999056255676657,0.5999056255676658
3,1,28,0.6169154228855721,0.6246418338108882,0.6543535620052771,0.5860215053763441,0.6350832266325224,0.6047156726768377,379,372,218,154,131,248,0.6205059920106525,0.6201875336908105,0.6201875336908106
3,1,29,0.5924170616113744,0.6534954407294833,0.6868131868131868,0.5555555555555556,0.6361323155216285,0.6005586592178771,364,387,215,172,114,250,0.6191744340878829,0.6211843711843712,0.6211843711843712
3,1,30,0.5843828715365239,0.5932203389830508,0.6170212765957447,0.56,0.6002587322121604,0.5761316872427984,376,375,210,165,144,232,0.5885486018641811,0.5885106382978724,0.5885106382978723
3,1,31,0.5889423076923077,0.6238805970149254,0.660377358490566,0.55,0.6226175349428209,0.5846153846153846,371,380,209,171,126,245,0.6045272969374168,0.6051886792452831,0.6051886792452831
3,1,32,0.6072351421188631,0.6263736263736264,0.633423180592992,0.6,0.6200527704485488,0.6129032258064515,371,380,228,152,136,235,0.6165113182423435,0.6167115902964959,0.616711590296496
3,1,33,0.6428571428571429,0.6518105849582173,0.6684350132625995,0.6256684491978609,0.6553966189856957,0.6384720327421555,377,374,234,140,125,252,0.6471371504660453,0.6470517312302303,0.6470517312302302
3,1,34,0.581453634085213,0.6107954545454546,0.6287262872628726,0.56282722513089,0.6041666666666667,0.5858310626702998,369,382,215,167,137,232,0.5952063914780293,0.5957767561968813,0.5957767561968813
3,1,35,0.6150121065375302,0.6715976331360947,0.6958904109589041,0.5880829015544041,0.6529562982005142,0.6270718232044199,365,386,227,159,111,254,0.640479360852197,0.6419866562566541,0.6419866562566541
3,1,36,0.59375,0.6149253731343284,0.6569148936170213,0.5493333333333333,0.6237373737373737,0.5802816901408451,376,375,206,169,129,247,0.6031957390146472,0.6031241134751772,0.6031241134751772
3,1,37,0.6298200514138818,0.649171270718232,0.6586021505376344,0.6200527704485488,0.6438896189224704,0.6342780026990553,372,379,235,144,127,245,0.6391478029294274,0.6393274604930916,0.6393274604930916
3,1,38,0.6033653846153846,0.6179104477611941,0.662269129287599,0.5564516129032258,0.631446540880503,0.5855728429985856,379,372,207,165,128,251,0.6098535286284953,0.6093603710954123,0.6093603710954124
3,1,39,0.6039119804400978,0.6345029239766082,0.6639784946236559,0.5725593667546174,0.6325224071702945,0.6019417475728155,372,379,217,162,125,247,0.6178428761651131,0.6182689306891367,0.6182689306891367
3,1,40,0.5796019900497512,0.6131805157593123,0.6331521739130435,0.5587467362924282,0.6051948051948051,0.5846994535519126,368,383,214,169,135,233,0.5952063914780293,0.5959494551027358,0.5959494551027358
3,1,41,0.59375,0.5970149253731343,0.6465968586387435,0.5420054200542005,0.6190476190476192,0.5681818181818181,382,369,200,169,135,247,0.5952063914780293,0.5943011393464721,0.5943011393464719
3,1,42,0.6184834123222749,0.6382978723404256,0.6868421052631579,0.5660377358490566,0.6508728179551122,0.6,380,371,210,161,119,261,0.6271637816245007,0.6264399205561073,0.6264399205561072
3,1,43,0.6031331592689295,0.592391304347826,0.6062992125984252,0.5891891891891892,0.6047120418848168,0.5907859078590786,381,370,218,152,150,231,0.5978695073235686,0.5977442008938072,0.5977442008938072
3,1,44,0.6096938775510204,0.6183844011142061,0.6356382978723404,0.592,0.6223958333333334,0.6049046321525885,376,375,222,153,137,239,0.6138482023968043,0.6138191489361702,0.6138191489361703
3,1,45,0.5990675990675991,0.65527950310559,0.6983695652173914,0.5509138381201044,0.6449184441656212,0.5985815602836879,368,383,211,172,111,257,0.6231691078561917,0.6246417016687479,0.624641701668748
3,1,46,0.6203473945409429,0.632183908045977,0.6613756613756614,0.5898123324396782,0.6402048655569783,0.6102635228848821,378,373,220,153,128,250,0.625832223701731,0.6255939969076698,0.6255939969076698
3,1,47,0.6218274111675127,0.6330532212885154,0.651595744680851,0.6026666666666667,0.6363636363636364,0.6174863387978141,376,375,226,149,131,245,0.6271637816245007,0.6271312056737589,0.627131205673759
3,1,48,0.6219512195121951,0.6627565982404692,0.6891891891891891,0.5931758530183727,0.6538461538461539,0.6260387811634349,370,381,226,155,115,255,0.640479360852197,0.6411825211037809,0.641182521103781
3,1,49,0.6142857142857143,0.6555891238670695,0.6935483870967742,0.5725593667546174,0.6515151515151515,0.6112676056338028,372,379,217,162,114,258,0.6324900133155792,0.6330538769256958,0.6330538769256958
3,1,50,0.6081730769230769,0.608955223880597,0.6588541666666666,0.555858310626703,0.6324999999999998,0.5811965811965812,384,367,204,163,131,253,0.6085219707057257,0.6073562386466848,0.6073562386466849
3,1,51,0.6262376237623762,0.659942363112392,0.6819407008086253,0.6026315789473684,0.6529032258064517,0.6299862448418156,371,380,229,151,118,253,0.6418109187749668,0.6422861398779969,0.6422861398779969
3,1,52,0.6434316353887399,0.656084656084656,0.6486486486486487,0.6509186351706037,0.6460296096904442,0.6534914361001317,370,381,248,133,130,240,0.6498002663115846,0.6497836419096261,0.6497836419096261
3,1,53,0.5990453460620525,0.6325301204819277,0.6729222520107239,0.5555555555555556,0.6338383838383839,0.5915492957746478,373,378,210,168,122,251,0.6138482023968043,0.6142389037831397,0.6142389037831397
3,1,54,0.6035353535353535,0.6253521126760564,0.6424731182795699,0.5857519788918206,0.6223958333333333,0.6049046321525886,372,379,222,157,133,239,0.6138482023968043,0.6141125485856953,0.6141125485856952
3,1,55,0.5896805896805897,0.6104651162790697,0.6417112299465241,0.5570291777188329,0.6145966709346992,0.5825242718446603,374,377,210,167,134,240,0.5992010652463382,0.5993702038326785,0.5993702038326785
3,1,56,0.6322115384615384,0.6507462686567164,0.6921052631578948,0.5876010781671159,0.6608040201005025,0.6175637393767704,380,371,218,153,117,263,0.640479360852197,0.6398531706625054,0.6398531706625054
3,1,57,0.6070588235294118,0.6288343558282209,0.6807387862796834,0.5510752688172043,0.6417910447761195,0.5873925501432665,379,372,205,167,121,258,0.6165113182423435,0.6159070275484438,0.6159070275484438
3,1,58,0.6128205128205129,0.6260387811634349,0.6390374331550802,0.5994694960212201,0.62565445026178,0.6124661246612466,374,377,226,151,135,239,0.6191744340878829,0.6192534645881502,0.6192534645881501
3,1,59,0.6111111111111112,0.6379821958456974,0.6746666666666666,0.5718085106382979,0.6413181242078582,0.603085553997195,375,376,215,161,122,253,0.6231691078561917,0.6232375886524822,0.6232375886524824
3,1,60,0.5801526717557252,0.5977653631284916,0.6129032258064516,0.5646437994722955,0.596078431372549,0.5807327001356852,372,379,214,165,144,228,0.5885486018641811,0.5887735126393735,0.5887735126393736
3,1,61,0.6167076167076168,0.6511627906976745,0.6765498652291105,0.5894736842105263,0.6452442159383034,0.6187845303867403,371,380,224,156,120,251,0.6324900133155792,0.6330117747198185,0.6330117747198184
3,1,62,0.5906862745098039,0.597667638483965,0.6358839050131926,0.5510752688172043,0.6124523506988564,0.5734265734265734,379,372,205,167,138,241,0.5938748335552596,0.5934795869151984,0.5934795869151984
3,1,63,0.6019900497512438,0.6275071633237822,0.6505376344086021,0.5778364116094987,0.6253229974160208,0.6016483516483515,372,379,219,160,130,242,0.6138482023968043,0.6141870230090504,0.6141870230090504
3,1,64,0.6136919315403423,0.6111111111111112,0.6536458333333334,0.5694822888283378,0.6330390920554855,0.5895627644569816,384,367,209,158,133,251,0.6125166444740346,0.6115640610808357,0.6115640610808355
3,1,65,0.6296296296296297,0.661849710982659,0.6854838709677419,0.604221635883905,0.6563706563706563,0.6317241379310344,372,379,229,150,117,255,0.644474034620506,0.6448527534258235,0.6448527534258235
3,1,66,0.6287128712871287,0.6368876080691642,0.6684210526315789,0.5956873315363881,0.6479591836734694,0.6155988857938718,380,371,221,150,126,254,0.6324900133155792,0.6320541920839836,0.6320541920839835
3,1,67,0.6262376237623762,0.6282420749279539,0.662303664921466,0.5907859078590786,0.6437659033078881,0.6089385474860335,382,369,218,151,129,253,0.6271637816245007,0.6265447863902722,0.6265447863902722
3,1,68,0.5946601941747572,0.6106194690265486,0.649867374005305,0.553475935828877,0.6210392902408112,0.5806451612903225,377,374,207,167,132,245,0.6018641810918774,0.601671654917091,0.6016716549170911
3,1,69,0.6194029850746269,0.6446991404011462,0.6675603217158177,0.5952380952380952,0.6425806451612903,0.6189821182943605,373,378,225,153,124,249,0.6311584553928096,0.6313992084769564,0.6313992084769565
3,1,70,0.592326139088729,0.6287425149700598,0.6657681940700808,0.5526315789473685,0.6269035532994924,0.5882352941176471,371,380,210,170,124,247,0.6085219707057257,0.6091998865087246,0.6091998865087247
3,1,71,0.608355091383812,0.6277173913043478,0.6297297297297297,0.6062992125984252,0.6188579017264276,0.616822429906542,370,381,231,150,137,233,0.6178428761651131,0.6180144711640775,0.6180144711640775
3,1,72,0.6054590570719603,0.6206896551724138,0.648936170212766,0.576,0.6264441591784339,0.5975103734439834,376,375,216,159,132,244,0.6125166444740346,0.6124680851063831,0.6124680851063831
3,1,73,0.6129032258064516,0.6206896551724138,0.6517150395778364,0.5806451612903226,0.6317135549872124,0.6000000000000001,379,372,216,156,132,247,0.6165113182423435,0.6161801004340794,0.6161801004340794
3,1,74,0.6340852130325815,0.6363636363636364,0.6640419947506562,0.6054054054054054,0.6487179487179486,0.6204986149584488,381,370,224,146,128,253,0.6351531291611185,0.6347237000780308,0.6347237000780308
3,1,75,0.6344339622641509,0.6574923547400612,0.7060367454068242,0.581081081081081,0.6683229813664596,0.6169296987087517,381,370,215,155,112,269,0.644474034620506,0.6435589132439526,0.6435589132439526
3,1,76,0.6126582278481013,0.6123595505617978,0.6368421052631579,0.5876010781671159,0.6245161290322581,0.5997248968363137,380,371,218,153,138,242,0.6125166444740346,0.6122215917151369,0.6122215917151369
3,1,77,0.5985915492957746,0.6276923076923077,0.6781914893617021,0.544,0.6359102244389028,0.5828571428571427,376,375,204,171,121,255,0.611185086551265,0.6110957446808511,0.611095744680851
3,1,78,0.6172839506172839,0.6416184971098265,0.6684491978609626,0.5888594164456233,0.6418485237483953,0.6141078838174273,374,377,222,155,124,250,0.6284953395472703,0.628654307153293,0.628654307153293
3,1,79,0.574025974025974,0.6010928961748634,0.6021798365122616,0.5729166666666666,0.5877659574468085,0.5866666666666666,367,384,220,164,146,221,0.5872170439414115,0.5875482515894642,0.5875482515894641
3,1,80,0.6078886310904872,0.653125,0.7024128686327078,0.5529100529100529,0.6517412935323382,0.5988538681948424,373,378,209,169,111,262,0.6271637816245007,0.6276614607713804,0.6276614607713804
3,1,81,0.6029411764705882,0.60932944606414,0.6473684210526316,0.5633423180592992,0.6243654822335024,0.5854341736694678,380,371,209,162,134,246,0.6058588548601864,0.6053553695559654,0.6053553695559655
3,1,82,0.5945945945945946,0.6162790697674418,0.6470588235294118,0.5623342175066313,0.619718309859155,0.5880721220527045,374,377,212,165,132,242,0.6045272969374168,0.6046965205180215,0.6046965205180215
3,1,83,0.6186868686868687,0.6112676056338028,0.639686684073107,0.5896739130434783,0.6290115532734275,0.6002766251728908,383,368,217,151,138,245,0.6151797603195739,0.6146802985582926,0.6146802985582926
3,1,84,0.576036866359447,0.6277602523659306,0.6793478260869565,0.5195822454308094,0.6234413965087281,0.5685714285714286,368,383,199,184,118,250,0.5978695073235686,0.599465035758883,0.599465035758883
3,1,85,0.6048780487804878,0.6363636363636364,0.6666666666666666,0.5725593667546174,0.6342710997442454,0.6027777777777779,372,379,217,162,124,248,0.6191744340878829,0.619613016710642,0.6196130167106421
3,1,86,0.6295336787564767,0.6328767123287671,0.6445623342175066,0.6176470588235294,0.6369593709043251,0.625169147496617,377,374,231,143,134,243,0.6311584553928096,0.631104696520518,0.631104696520518
3,1,87,0.5829493087557603,0.6435331230283912,0.6912568306010929,0.5298701298701298,0.6325000000000001,0.5811965811965811,366,385,204,181,113,253,0.6085219707057257,0.6105634802356112,0.6105634802356114
3,1,88,0.6183574879227053,0.6112759643916914,0.661498708010336,0.5659340659340659,0.6392009987515606,0.5877318116975748,387,364,206,158,131,256,0.6151797603195739,0.613716386972201,0.6137163869722008
3,1,89,0.6184834123222749,0.6504559270516718,0.6941489361702128,0.5706666666666667,0.6541353383458648,0.6079545454545455,376,375,214,161,115,261,0.6324900133155792,0.6324078014184397,0.6324078014184398
3,1,90,0.5951219512195122,0.6187683284457478,0.6524064171122995,0.5596816976127321,0.6224489795918368,0.5877437325905291,374,377,211,166,130,244,0.6058588548601864,0.6060440573625158,0.6060440573625158
3,1,91,0.578088578088578,0.6149068322981367,0.6666666666666666,0.5224274406332454,0.6192259675405744,0.5649072753209702,372,379,198,181,124,248,0.5938748335552596,0.594547053649956,0.5945470536499561
3,1,92,0.6340852130325815,0.6534090909090909,0.6746666666666666,0.6117021276595744,0.6537467700258398,0.6318681318681318,375,376,230,146,122,253,0.6431424766977364,0.6431843971631205,0.6431843971631206
3,1,93,0.5934579439252337,0.628482972136223,0.679144385026738,0.5384615384615384,0.6334164588528678,0.58,374,377,203,174,120,254,0.6085219707057257,0.6088029617441382,0.6088029617441382
3,1,94,0.6183206106870229,0.6368715083798883,0.6514745308310992,0.6031746031746031,0.6344647519582246,0.6195652173913043,373,378,228,150,130,243,0.6271637816245007,0.6273245670028512,0.6273245670028511
3,1,95,0.6048780487804878,0.6363636363636364,0.6666666666666666,0.5725593667546174,0.6342710997442454,0.6027777777777779,372,379,217,162,124,248,0.6191744340878829,0.619613016710642,0.6196130167106421
3,1,96,0.6036745406824147,0.6135135135135135,0.6166219839142091,0.6005291005291006,0.6100795755968169,0.6069518716577539,373,378,227,151,143,230,0.6085219707057257,0.6085755422216548,0.6085755422216548
3,1,97,0.6127320954907162,0.6096256684491979,0.6127320954907162,0.6096256684491979,0.6127320954907162,0.6096256684491979,377,374,228,146,146,231,0.611185086551265,0.611178881969957,0.6111788819699571
3,1,98,0.6170731707317073,0.6656891495601173,0.6893732970027248,0.5911458333333334,0.6512226512226512,0.6262068965517241,367,384,227,157,114,253,0.6391478029294274,0.6402595651680291,0.6402595651680292
3,1,99,0.6104218362282878,0.6494252873563219,0.6684782608695652,0.5900783289817232,0.6381322957198443,0.6183310533515732,368,383,226,157,122,246,0.6284953395472703,0.6292782949256442,0.6292782949256441
5,1,0,0.6212871287128713,0.6167146974063401,0.6536458333333334,0.5831062670299727,0.6370558375634517,0.599439775910364,384,367,214,153,133,251,0.6191744340878829,0.6183760501816531,0.618376050181653
5,1,1,0.6014319809069213,0.6536144578313253,0.6866485013623979,0.5651041666666666,0.6412213740458017,0.606145251396648,367,384,217,167,115,252,0.6245006657789614,0.6258763340145324,0.6258763340145321
5,1,2,0.6365914786967418,0.6534090909090909,0.675531914893617,0.6133333333333333,0.6554838709677419,0.6327372764786796,376,375,230,145,122,254,0.644474034620506,0.6444326241134751,0.6444326241134751
5,1,3,0.6253164556962025,0.6376404494382022,0.6569148936170213,0.6053333333333333,0.6407263294422828,0.6210670314637482,376,375,227,148,129,247,0.6311584553928096,0.6311241134751773,0.6311241134751773
5,1,4,0.6,0.6096866096866097,0.636604774535809,0.5721925133689839,0.6177606177606176,0.5903448275862069,377,374,214,160,137,240,0.6045272969374168,0.6043986439523965,0.6043986439523965
5,1,5,0.6370757180156658,0.625,0.6387434554973822,0.6233062330623306,0.6379084967320262,0.6241519674355495,382,369,230,139,138,244,0.6311584553928096,0.6310248442798565,0.6310248442798565
5,1,6,0.6384039900249376,0.6628571428571428,0.6844919786096256,0.6153846153846154,0.6606451612903226,0.6382393397524071,374,377,232,145,118,256,0.6498002663115846,0.6499382969971206,0.6499382969971206
5,1,7,0.618925831202046,0.6166666666666667,0.6368421052631579,0.5983827493261455,0.6277561608300908,0.6073871409028728,380,371,222,149,138,242,0.6178428761651131,0.6176124272946517,0.6176124272946517
5,1,8,0.6449086161879896,0.6385869565217391,0.65,0.633423180592992,0.6474442988204456,0.6359945872801084,380,371,235,136,133,247,0.6418109187749668,0.6417115902964959,0.641711590296496
5,1,9,0.6465968586387435,0.6368563685636857,0.6482939632545932,0.6351351351351351,0.6474442988204457,0.6359945872801083,381,370,235,135,134,247,0.6418109187749668,0.6417145491948641,0.6417145491948641
5,1,10,0.628992628992629,0.6482558139534884,0.6790450928381963,0.5962566844919787,0.6530612244897959,0.6211699164345404,377,374,223,151,121,256,0.6378162450066578,0.6376508886650873,0.6376508886650876
5,1,11,0.605568445475638,0.65,0.6997319034852547,0.5502645502645502,0.6492537313432836,0.5959885386819485,373,378,208,170,112,261,0.6245006657789614,0.6249982268749025,0.6249982268749025
5,1,12,0.6299019607843137,0.6472303206997084,0.6798941798941799,0.5951742627345844,0.653944020356234,0.6201117318435754,378,373,222,151,121,257,0.6378162450066578,0.6375342213143822,0.6375342213143822
5,1,13,0.6501305483028721,0.6467391304347826,0.6569920844327177,0.6397849462365591,0.6535433070866142,0.6432432432432432,379,372,238,134,130,249,0.6484687083888149,0.6483885153346384,0.6483885153346384
5,1,14,0.6399026763990268,0.6676470588235294,0.699468085106383,0.6053333333333333,0.6683608640406608,0.634965034965035,376,375,227,148,113,263,0.6524633821571239,0.6524007092198582,0.6524007092198583
5,1,15,0.611764705882353,0.6717791411042945,0.7084468664850136,0.5703125,0.6565656565656567,0.6169014084507043,367,384,219,165,107,260,0.6378162450066578,0.6393796832425068,0.6393796832425068
5,1,16,0.6372549019607843,0.673469387755102,0.6989247311827957,0.6094986807387863,0.6666666666666666,0.6398891966759004,372,379,231,148,112,260,0.6537949400798935,0.654211705960791,0.654211705960791
5,1,17,0.6098654708520179,0.6819672131147541,0.7371273712737128,0.5445026178010471,0.667484662576687,0.6055312954876273,369,382,208,174,97,272,0.6391478029294274,0.64081499453738,0.64081499453738
5,1,18,0.648854961832061,0.6564245810055865,0.6746031746031746,0.6300268096514745,0.66147859922179,0.6429548563611491,378,373,235,138,123,255,0.6524633821571239,0.6523149921273246,0.6523149921273246
5,1,19,0.5892018779342723,0.6061538461538462,0.662269129287599,0.5295698924731183,0.6236024844720497,0.5652797704447632,379,372,197,175,128,251,0.596537949400799,0.5959195108803587,0.5959195108803587
5,1,20,0.6181384248210023,0.6385542168674698,0.683377308707124,0.5698924731182796,0.6491228070175438,0.6022727272727274,379,372,212,160,120,259,0.6271637816245007,0.6266348909127017,0.6266348909127017
5,1,21,0.6019184652278178,0.6197604790419161,0.6640211640211641,0.5549597855227882,0.6314465408805032,0.5855728429985856,378,373,207,166,127,251,0.6098535286284953,0.6094904747719762,0.6094904747719762
5,1,22,0.654228855721393,0.6590257879656161,0.6884816753926701,0.6233062330623306,0.6709183673469387,0.6406685236768802,382,369,230,139,119,263,0.6564580559254327,0.6558939542275004,0.6558939542275004
5,1,23,0.6328502415458938,0.655786350148368,0.6931216931216931,0.5924932975871313,0.6616161616161617,0.6225352112676057,378,373,221,152,116,262,0.6431424766977364,0.6428074953544122,0.6428074953544123
5,1,24,0.6247086247086248,0.6832298136645962,0.7243243243243244,0.5774278215223098,0.6708385481852316,0.6258890469416786,370,381,220,161,102,268,0.6498002663115846,0.650876072923317,0.6508760729233171
5,1,25,0.6075949367088608,0.6348314606741573,0.6486486486486487,0.5931758530183727,0.6274509803921569,0.6132971506105834,370,381,226,155,130,240,0.6205059920106525,0.6209122508335108,0.6209122508335108
5,1,26,0.5946547884187082,0.6556291390728477,0.7196765498652291,0.5210526315789473,0.6512195121951219,0.5806451612903225,371,380,198,182,104,267,0.6191744340878829,0.6203645907220883,0.6203645907220883
5,1,27,0.6385542168674698,0.6607142857142857,0.6992084432717678,0.5967741935483871,0.6675062972292191,0.6271186440677966,379,372,222,150,114,265,0.6484687083888149,0.6479913184100775,0.6479913184100774
5,1,28,0.6068796068796068,0.6366279069767442,0.6639784946236559,0.5778364116094987,0.6341463414634145,0.6058091286307054,372,379,219,160,125,247,0.6205059920106525,0.6209074531165774,0.6209074531165774
5,1,29,0.6067146282973621,0.6317365269461078,0.6728723404255319,0.5626666666666666,0.6380832282471627,0.5952045133991537,376,375,211,164,123,253,0.6178428761651131,0.6177695035460993,0.6177695035460993
5,1,30,0.6053268765133172,0.6301775147928994,0.6666666666666666,0.5664893617021277,0.6345177664974619,0.5966386554621849,375,376,213,163,125,250,0.6165113182423435,0.6165780141843971,0.6165780141843972
5,1,31,0.6069651741293532,0.6074498567335244,0.6404199475065617,0.572972972972973,0.6232439335887612,0.5897079276773296,381,370,212,158,137,244,0.607190412782956,0.6066964602397673,0.6066964602397673
5,1,32,0.649867374005305,0.6764705882352942,0.6693989071038251,0.6571428571428571,0.6594885598923284,0.6666666666666666,366,385,253,132,121,245,0.6631158455392809,0.6632708821233412,0.6632708821233411
5,1,33,0.64,0.6410256410256411,0.6701570680628273,0.6097560975609756,0.6547314578005116,0.625,382,369,225,144,126,256,0.640479360852197,0.6399565828119014,0.6399565828119015
5,1,34,0.6329411764705882,0.6687116564417178,0.713527851458886,0.5828877005347594,0.6708229426433915,0.6228571428571429,377,374,218,156,108,269,0.6484687083888149,0.6482077759968227,0.6482077759968227
5,1,35,0.6378896882494005,0.6497005988023952,0.6945169712793734,0.5896739130434783,0.665,0.6182336182336182,383,368,217,151,117,266,0.6431424766977364,0.6420954421614259,0.6420954421614258
5,1,36,0.6033254156769596,0.6424242424242425,0.6827956989247311,0.5593667546174143,0.6406052963430012,0.5980253878702398,372,379,212,167,118,254,0.6205059920106525,0.6210812267710726,0.6210812267710728
5,1,37,0.66,0.6695156695156695,0.6947368421052632,0.633423180592992,0.676923076923077,0.6509695290858727,380,371,235,136,116,264,0.6644474034620506,0.6640800113491275,0.6640800113491274
5,1,38,0.6304909560723514,0.6510989010989011,0.6576819407008087,0.6236842105263158,0.6437994722955145,0.6370967741935485,371,380,237,143,127,244,0.640479360852197,0.6406830756135622,0.6406830756135622
5,1,39,0.6367924528301887,0.6819571865443425,0.7219251336898396,0.5915119363395226,0.6766917293233083,0.6335227272727273,374,377,223,154,104,270,0.6564580559254327,0.656718535014681,0.6567185350146811
5,1,40,0.6401985111662531,0.6551724137931034,0.6825396825396826,0.6112600536193029,0.6606914212548015,0.6324549237170596,378,373,228,145,120,258,0.6471371504660453,0.6468998680794927,0.6468998680794927
5,1,41,0.6057692307692307,0.6447761194029851,0.6792452830188679,0.5684210526315789,0.6404066073697585,0.6041958041958042,371,380,216,164,119,252,0.6231691078561917,0.6238331678252234,0.6238331678252235
5,1,42,0.6008869179600886,0.6466666666666666,0.7188328912466844,0.5187165775401069,0.6545893719806763,0.5756676557863502,377,374,194,180,106,271,0.6191744340878829,0.6187747343933957,0.6187747343933956
5,1,43,0.5975,0.6296296296296297,0.6476964769647696,0.5785340314136126,0.6215864759427828,0.6030013642564802,369,382,221,161,130,239,0.6125166444740346,0.6131152541891911,0.6131152541891911
5,1,44,0.6225,0.6438746438746439,0.6657754010695187,0.5994694960212201,0.6434108527131783,0.6208791208791209,374,377,226,151,125,249,0.6324900133155792,0.6326224485453693,0.6326224485453694
5,1,45,0.6358974358974359,0.631578947368421,0.6509186351706037,0.6162162162162163,0.6433203631647212,0.6238030095759234,381,370,228,142,133,248,0.6338215712383488,0.6335674256934098,0.63356742569341
5,1,46,0.6305418719211823,0.6405797101449275,0.6736842105263158,0.5956873315363881,0.6513994910941476,0.61731843575419,380,371,221,150,124,256,0.6351531291611185,0.6346857710313519,0.6346857710313518
5,1,47,0.6502463054187192,0.6492753623188405,0.6857142857142857,0.6120218579234973,0.6675094816687738,0.630098452883263,385,366,224,142,121,264,0.6498002663115846,0.6488680718188915,0.6488680718188915
5,1,48,0.6398963730569949,0.6493150684931507,0.6586666666666666,0.6303191489361702,0.6491458607095927,0.6396761133603239,375,376,237,139,128,247,0.644474034620506,0.6444929078014183,0.6444929078014184
5,1,49,0.6107226107226107,0.6490683229813664,0.6986666666666667,0.5558510638297872,0.6517412935323383,0.5988538681948424,375,376,209,167,113,262,0.6271637816245007,0.6272588652482269,0.6272588652482269
5,1,50,0.6578313253012048,0.6875,0.7222222222222222,0.6193029490616622,0.6885245901639344,0.6516220028208745,378,373,231,142,105,273,0.6711051930758988,0.6707625856419422,0.6707625856419422
5,1,51,0.6023529411764705,0.6380368098159509,0.6844919786096256,0.5517241379310345,0.6408010012515645,0.5917496443812232,374,377,208,169,118,256,0.6178428761651131,0.6181080582703301,0.6181080582703302
5,1,52,0.6365914786967418,0.6448863636363636,0.6701846965699209,0.6102150537634409,0.6529562982005142,0.6270718232044199,379,372,227,145,125,254,0.640479360852197,0.6401998751666809,0.640199875166681
5,1,53,0.6074074074074074,0.6416184971098265,0.6648648648648648,0.5826771653543307,0.6348387096774193,0.6107290233837689,370,381,222,159,124,246,0.6231691078561917,0.6237710151095979,0.6237710151095978
5,1,54,0.6322418136020151,0.635593220338983,0.6605263157894737,0.6064690026954178,0.6460746460746462,0.6206896551724137,380,371,225,146,129,251,0.6338215712383488,0.6334976592424457,0.6334976592424457
5,1,55,0.6159600997506235,0.6542857142857142,0.6711956521739131,0.597911227154047,0.6423927178153446,0.6248294679399726,368,383,229,154,121,247,0.6338215712383488,0.63455343966398,0.6345534396639801
5,1,56,0.6456310679611651,0.6755162241887905,0.7074468085106383,0.6106666666666667,0.6751269035532995,0.6414565826330533,376,375,229,146,110,266,0.6591211717709721,0.6590567375886526,0.6590567375886524
5,1,57,0.6268292682926829,0.6158357771260997,0.6623711340206185,0.5785123966942148,0.644110275689223,0.5965909090909091,388,363,210,153,131,257,0.6218375499334221,0.6204417653574167,0.6204417653574167
5,1,58,0.6287128712871287,0.6426512968299711,0.671957671957672,0.5978552278820375,0.6496163682864451,0.6194444444444444,378,373,223,150,124,254,0.6351531291611185,0.6349064499198548,0.6349064499198548
5,1,59,0.6151960784313726,0.6530612244897959,0.6783783783783783,0.5879265091863517,0.6452442159383033,0.6187845303867403,370,381,224,157,119,251,0.6324900133155792,0.633152443782365,0.633152443782365
5,1,60,0.6187050359712231,0.6467065868263473,0.6861702127659575,0.576,0.6506935687263555,0.609308885754584,376,375,216,159,118,258,0.6311584553928096,0.6310851063829788,0.6310851063829788
5,1,61,0.6308068459657702,0.6549707602339181,0.6861702127659575,0.5973333333333334,0.6573248407643313,0.6248256624825663,376,375,224,151,118,258,0.6418109187749668,0.6417517730496453,0.6417517730496454
5,1,62,0.6159420289855072,0.6350148367952523,0.6746031746031746,0.5737265415549598,0.6439393939393939,0.6028169014084508,378,373,214,159,123,255,0.6245006657789614,0.6241648580790672,0.6241648580790672
5,1,63,0.619277108433735,0.6398809523809523,0.6798941798941799,0.5764075067024129,0.6481715006305171,0.6064880112834979,378,373,215,158,121,257,0.6284953395472703,0.6281508432982964,0.6281508432982965
5,1,64,0.6206896551724138,0.6289855072463768,0.6631578947368421,0.5849056603773585,0.6412213740458015,0.6061452513966481,380,371,217,154,128,252,0.6245006657789614,0.6240317775571003,0.6240317775571004
5,1,65,0.6372549019607843,0.6559766763848397,0.6878306878306878,0.6032171581769437,0.6615776081424936,0.6284916201117318,378,373,225,148,118,260,0.6458055925432756,0.6455239230038158,0.6455239230038158
5,1,66,0.6240963855421687,0.6875,0.7115384615384616,0.5968992248062015,0.6649550706033376,0.6390041493775933,364,387,231,156,105,259,0.6524633821571239,0.6542188431723316,0.6542188431723315
5,1,67,0.5855855855855856,0.6319218241042345,0.6970509383378016,0.5132275132275133,0.6364749082007345,0.5664233576642335,373,378,194,184,113,260,0.6045272969374168,0.6051392257826574,0.6051392257826574
5,1,68,0.5966981132075472,0.6452599388379205,0.6856368563685636,0.5523560209424084,0.6380832282471626,0.5952045133991538,369,382,211,171,116,253,0.6178428761651131,0.618996438655486,0.618996438655486
5,1,69,0.629976580796253,0.6759259259259259,0.7192513368983957,0.5809018567639257,0.6716604244694132,0.6248216833095578,374,377,219,158,105,269,0.6498002663115846,0.6500765968311607,0.6500765968311607
5,1,70,0.639225181598063,0.6449704142011834,0.6875,0.5940054495912807,0.6624843161856964,0.6184397163120566,384,367,218,149,120,264,0.6418109187749668,0.6407527247956404,0.6407527247956404
5,1,71,0.6446700507614214,0.6610644257703081,0.6773333333333333,0.6276595744680851,0.6605981794538361,0.6439290586630286,375,376,236,140,121,254,0.6524633821571239,0.6524964539007092,0.6524964539007092
5,1,72,0.6084905660377359,0.654434250764526,0.6954177897574124,0.5631578947368421,0.649056603773585,0.6053748231966054,371,380,214,166,113,258,0.6284953395472703,0.6292878422471272,0.6292878422471272
5,1,73,0.6395061728395062,0.653179190751445,0.683377308707124,0.6075268817204301,0.6607142857142857,0.6295264623955432,379,372,226,146,120,259,0.6458055925432756,0.645452095213777,0.6454520952137771
5,1,74,0.6372795969773299,0.6468926553672316,0.6693121693121693,0.613941018766756,0.6529032258064515,0.6299862448418156,378,373,229,144,125,253,0.6418109187749668,0.6416265940394626,0.6416265940394626
5,1,75,0.5985915492957746,0.6430769230769231,0.6873315363881402,0.55,0.6398996235884568,0.5929078014184398,371,380,209,171,116,255,0.6178428761651131,0.61866576819407,0.6186657681940702
5,1,76,0.6057007125890737,0.6090909090909091,0.6640625,0.547683923705722,0.6335403726708074,0.5767575322812052,384,367,201,166,129,255,0.607190412782956,0.605873211852861,0.605873211852861
5,1,77,0.5980861244019139,0.6246246246246246,0.6666666666666666,0.5531914893617021,0.6305170239596469,0.5867418899858957,375,376,208,168,125,250,0.6098535286284953,0.6099290780141844,0.6099290780141845
5,1,78,0.6246913580246913,0.6271676300578035,0.662303664921466,0.5880758807588076,0.6429479034307497,0.6069930069930071,382,369,217,152,129,253,0.625832223701731,0.6251897728401368,0.6251897728401368
5,1,79,0.6368159203980099,0.6532951289398281,0.6790450928381963,0.6096256684491979,0.6572528883183568,0.6307053941908713,377,374,228,146,121,256,0.644474034620506,0.644335380643697,0.6443353806436971
5,1,80,0.6288659793814433,0.6225895316804407,0.6404199475065617,0.6108108108108108,0.6345903771131339,0.616643929058663,381,370,226,144,137,244,0.625832223701731,0.6256153791586863,0.6256153791586863
5,1,81,0.6235011990407674,0.6497005988023952,0.6896551724137931,0.5802139037433155,0.654911838790932,0.6129943502824858,377,374,217,157,117,260,0.6351531291611185,0.6349345380785543,0.6349345380785544
5,1,82,0.6510416666666666,0.6539509536784741,0.6631299734748011,0.6417112299465241,0.6570302233902758,0.6477732793522267,377,374,240,134,127,250,0.6524633821571239,0.6524206017106626,0.6524206017106625
5,1,83,0.5962877030162413,0.653125,0.6983695652173914,0.5456919060052219,0.6433041301627035,0.5945945945945945,368,383,209,174,111,257,0.6205059920106525,0.6220307356113066,0.6220307356113066
5,1,84,0.6433915211970075,0.64,0.671875,0.6103542234332425,0.6573248407643312,0.6248256624825662,384,367,224,143,126,258,0.6418109187749668,0.6411146117166213,0.6411146117166213
5,1,85,0.6092233009708737,0.6548672566371682,0.6820652173913043,0.5796344647519582,0.6435897435897435,0.6149584487534626,368,383,222,161,117,251,0.62982689747004,0.6308498410716312,0.6308498410716312
5,1,86,0.5898617511520737,0.6466876971608833,0.6956521739130435,0.5352480417754569,0.6384039900249376,0.5857142857142857,368,383,205,178,112,256,0.6138482023968043,0.6154501078442502,0.6154501078442502
5,1,87,0.6141176470588235,0.6595092024539877,0.7016129032258065,0.5672823218997362,0.6549560853199498,0.6099290780141844,372,379,215,164,111,261,0.6338215712383488,0.6344476125627714,0.6344476125627714
5,1,88,0.6262376237623762,0.6138328530259366,0.6537467700258398,0.5851648351648352,0.6396965865992414,0.5991561181434599,387,364,213,151,134,253,0.6205059920106525,0.6194558025953374,0.6194558025953375
5,1,89,0.6443298969072165,0.6418732782369146,0.6578947368421053,0.628032345013477,0.6510416666666667,0.6348773841961852,380,371,233,138,130,250,0.6431424766977364,0.6429635409277912,0.6429635409277912
5,1,90,0.6275510204081632,0.6183844011142061,0.6422976501305483,0.6032608695652174,0.6348387096774194,0.6107290233837689,383,368,222,146,137,246,0.6231691078561917,0.6227792598478827,0.6227792598478827
5,1,91,0.6368038740920097,0.6834319526627219,0.7108108108108108,0.6062992125984252,0.6717752234993615,0.6425591098748262,370,381,231,150,107,263,0.6577896138482024,0.658555011704618,0.658555011704618
5,1,92,0.6310432569974554,0.6452513966480447,0.6613333333333333,0.6143617021276596,0.6458333333333334,0.6294277929155313,375,376,231,145,127,248,0.6378162450066578,0.6378475177304964,0.6378475177304965
5,1,93,0.5952380952380952,0.6102719033232629,0.6596306068601583,0.543010752688172,0.6257822277847309,0.5746799431009957,379,372,202,170,129,250,0.6018641810918774,0.6013206797741651,0.6013206797741651
5,1,94,0.6096385542168675,0.6398809523809523,0.6764705882352942,0.5702917771883289,0.641318124207858,0.6030855539971949,374,377,215,162,121,253,0.6231691078561917,0.6233811827118115,0.6233811827118115
5,1,95,0.6231884057971014,0.6261127596439169,0.671875,0.5749318801089919,0.6466165413533834,0.5994318181818181,384,367,211,156,126,258,0.6245006657789614,0.6234034400544959,0.6234034400544959
5,1,96,0.6237864077669902,0.6519174041297935,0.6853333333333333,0.5877659574468085,0.653113087674714,0.6181818181818182,375,376,221,155,118,257,0.6364846870838882,0.636549645390071,0.636549645390071
5,1,97,0.6198547215496368,0.6538461538461539,0.6863270777479893,0.5846560846560847,0.6513994910941476,0.61731843575419,373,378,221,157,117,256,0.6351531291611185,0.635491581202037,0.635491581202037
5,1,98,0.6132075471698113,0.6636085626911316,0.7027027027027027,0.5695538057742782,0.6549118387909321,0.6129943502824858,370,381,217,164,110,260,0.6351531291611185,0.6361282542384904,0.6361282542384903
5,1,99,0.6171284634760705,0.6299435028248588,0.651595744680851,0.5946666666666667,0.6338939197930141,0.6117969821673526,376,375,223,152,131,245,0.6231691078561917,0.6231312056737589,0.623131205673759
7,1,0,0.6157635467980296,0.6405797101449275,0.6684491978609626,0.5862068965517241,0.6410256410256411,0.6121883656509695,374,377,221,156,124,250,0.6271637816245007,0.6273280472063434,0.6273280472063433
7,1,1,0.6220095693779905,0.6546546546546547,0.6933333333333334,0.5797872340425532,0.6557377049180328,0.614950634696756,375,376,218,158,115,260,0.6364846870838882,0.6365602836879433,0.6365602836879433
7,1,2,0.6225,0.6467236467236467,0.6675603217158177,0.6005291005291006,0.6442432082794308,0.6227709190672154,373,378,227,151,124,249,0.6338215712383488,0.6340447111224591,0.6340447111224591
7,1,3,0.6055276381909548,0.6288951841359773,0.6478494623655914,0.5857519788918206,0.625974025974026,0.6065573770491803,372,379,222,157,131,241,0.6165113182423435,0.6168007206287061,0.616800720628706
7,1,4,0.6151960784313726,0.6530612244897959,0.6783783783783783,0.5879265091863517,0.6452442159383033,0.6187845303867403,370,381,224,157,119,251,0.6324900133155792,0.633152443782365,0.633152443782365
7,1,5,0.6588541666666666,0.667574931880109,0.6746666666666666,0.651595744680851,0.6666666666666666,0.6594885598923284,375,376,245,131,122,253,0.6631158455392809,0.6631312056737589,0.6631312056737589
7,1,6,0.6123456790123457,0.638728323699422,0.6648793565683646,0.5846560846560847,0.6375321336760925,0.6104972375690608,373,378,221,157,125,248,0.6245006657789614,0.6247677206122246,0.6247677206122246
7,1,7,0.615979381443299,0.6198347107438017,0.6339522546419099,0.6016042780748663,0.6248366013071895,0.610583446404342,377,374,225,149,138,239,0.6178428761651131,0.6177782663583881,0.6177782663583881
7,1,8,0.60381861575179,0.6144578313253012,0.6640419947506562,0.5513513513513514,0.6325000000000001,0.5811965811965812,381,370,204,166,128,253,0.6085219707057257,0.6076966730510037,0.6076966730510038
7,1,9,0.645320197044335,0.663768115942029,0.6931216931216931,0.613941018766756,0.6683673469387756,0.637883008356546,378,373,229,144,116,262,0.6537949400798935,0.6535313559442245,0.6535313559442245
7,1,10,0.6328502415458938,0.6498516320474778,0.6894736842105263,0.5902964959568733,0.6599496221662469,0.6186440677966102,380,371,219,152,118,262,0.640479360852197,0.6398850900836999,0.6398850900836998
7,1,11,0.6109725685785536,0.6457142857142857,0.6639566395663956,0.5916230366492147,0.6363636363636364,0.6174863387978141,369,382,226,156,124,245,0.6271637816245007,0.6277898381078052,0.6277898381078051
7,1,12,0.656641604010025,0.6761363636363636,0.6968085106382979,0.6346666666666667,0.6761290322580645,0.6547455295735902,376,375,238,137,114,262,0.6657789613848203,0.6657375886524822,0.6657375886524823
7,1,13,0.6275,0.6210826210826211,0.6536458333333334,0.5940054495912807,0.6403061224489796,0.6072423398328691,384,367,218,149,133,251,0.6245006657789614,0.623825641462307,0.623825641462307
7,1,14,0.6313131313131313,0.6450704225352113,0.6648936170212766,0.6106666666666667,0.6476683937823833,0.6273972602739726,376,375,229,146,126,250,0.6378162450066578,0.6377801418439717,0.6377801418439717
7,1,15,0.6175,0.6239316239316239,0.6517150395778364,0.5887096774193549,0.6341463414634146,0.6058091286307054,379,372,219,153,132,247,0.6205059920106525,0.6202123584985956,0.6202123584985957
7,1,16,0.6446700507614214,0.6666666666666666,0.6809651474530831,0.6296296296296297,0.6623207301173403,0.6476190476190475,373,378,238,140,119,254,0.6551264980026631,0.6552973885413563,0.6552973885413564
7,1,17,0.5985221674876847,0.6376811594202898,0.6603260869565217,0.5744125326370757,0.6279069767441859,0.6043956043956044,368,383,220,163,125,243,0.6165113182423435,0.6173693097967987,0.6173693097967987
7,1,18,0.5942028985507246,0.6142433234421365,0.6542553191489362,0.552,0.6227848101265823,0.5814606741573034,376,375,207,168,130,246,0.6031957390146472,0.6031276595744681,0.6031276595744681
7,1,19,0.6121951219512195,0.6422287390029325,0.6729222520107239,0.5793650793650794,0.641123882503193,0.6091794158553546,373,378,219,159,122,251,0.625832223701731,0.6261436656879016,0.6261436656879017
7,1,20,0.6163366336633663,0.6311239193083573,0.6604774535809018,0.5855614973262032,0.6376440460947502,0.6074895977808599,377,374,219,155,128,249,0.6231691078561917,0.6230194754535525,0.6230194754535525
7,1,21,0.6423173803526449,0.652542372881356,0.6746031746031746,0.6193029490616622,0.6580645161290323,0.6354883081155434,378,373,231,142,123,255,0.6471371504660453,0.6469530618324184,0.6469530618324184
7,1,22,0.6354679802955665,0.6492753623188405,0.6807387862796834,0.6021505376344086,0.6573248407643313,0.6248256624825663,379,372,224,148,121,258,0.6418109187749668,0.6414446619570461,0.641444661957046
7,1,23,0.6104513064133017,0.6484848484848484,0.6890080428954424,0.5661375661375662,0.6473551637279596,0.6045197740112994,373,378,214,164,116,257,0.6271637816245007,0.6275728045165043,0.6275728045165042
7,1,24,0.6237113402061856,0.6418732782369146,0.6505376344086021,0.6147757255936676,0.6368421052631579,0.6280323450134772,372,379,233,146,130,242,0.6324900133155792,0.6326566800011348,0.6326566800011348
7,1,25,0.6265984654731458,0.6083333333333333,0.6347150259067358,0.6,0.6306306306306306,0.6041379310344827,386,365,219,146,141,245,0.6178428761651131,0.6173575129533679,0.6173575129533679
7,1,26,0.6,0.6314199395770392,0.6737967914438503,0.5543766578249337,0.6347607052896725,0.5903954802259886,374,377,209,168,122,252,0.6138482023968043,0.614086724634392,0.614086724634392
7,1,27,0.6352657004830918,0.6468842729970327,0.6884816753926701,0.5907859078590786,0.6608040201005024,0.6175637393767706,382,369,218,151,119,263,0.640479360852197,0.6396337916258744,0.6396337916258743
7,1,28,0.6168674698795181,0.6398809523809523,0.6790450928381963,0.5748663101604278,0.6464646464646465,0.6056338028169013,377,374,215,159,121,256,0.6271637816245007,0.6269557014993121,0.626955701499312
7,1,29,0.6479217603911981,0.6842105263157895,0.710455764075067,0.6190476190476191,0.6777493606138109,0.6500000000000001,373,378,234,144,108,265,0.6644474034620506,0.664751691561343,0.6647516915613431
7,1,30,0.633495145631068,0.6519174041297935,0.6886543535620053,0.5940860215053764,0.6599241466498105,0.6216596343178622,379,372,221,151,118,261,0.6418109187749668,0.6413701875336908,0.6413701875336909
7,1,31,0.645,0.6438746438746439,0.6736292428198434,0.6141304347826086,0.6590038314176245,0.6286509040333796,383,368,226,142,125,258,0.644474034620506,0.643879838801226,0.643879838801226
7,1,32,0.6061320754716981,0.6483180428134556,0.6908602150537635,0.5593667546174143,0.6457286432160805,0.6005665722379604,372,379,212,167,115,257,0.6245006657789614,0.6251134848355888,0.6251134848355888
7,1,33,0.628361858190709,0.6403508771929824,0.6763157894736842,0.5902964959568733,0.6514575411913816,0.6143057503506311,380,371,219,152,123,257,0.6338215712383488,0.6333061427152787,0.6333061427152787
7,1,34,0.6271604938271605,0.6560693641618497,0.6809651474530831,0.6005291005291006,0.6529562982005142,0.6270718232044199,373,378,227,151,119,254,0.640479360852197,0.6407471239910918,0.6407471239910918
7,1,35,0.6083743842364532,0.6173913043478261,0.6517150395778364,0.5725806451612904,0.6292993630573247,0.5941422594142259,379,372,213,159,132,247,0.6125166444740346,0.6121478423695633,0.6121478423695634
7,1,36,0.6726804123711341,0.6887052341597796,0.6978609625668449,0.6631299734748011,0.6850393700787402,0.6756756756756758,374,377,250,127,113,261,0.6804260985352862,0.680495468020823,0.6804954680208231
7,1,37,0.6332518337408313,0.6608187134502924,0.6906666666666667,0.601063829787234,0.6607142857142856,0.6295264623955432,375,376,226,150,116,259,0.6458055925432756,0.6458652482269504,0.6458652482269504
7,1,38,0.6130536130536131,0.6645962732919255,0.7088948787061995,0.5631578947368421,0.6575000000000001,0.6096866096866097,371,380,214,166,108,263,0.6351531291611185,0.6360263867215208,0.6360263867215208
7,1,39,0.6141176470588235,0.6533742331288344,0.6978609625668449,0.5649867374005305,0.6533166458072591,0.6059743954480796,374,377,213,164,113,261,0.6311584553928096,0.6314238499836877,0.6314238499836878
7,1,40,0.6102941176470589,0.6297376093294461,0.6622340425531915,0.576,0.6352040816326532,0.6016713091922006,376,375,216,159,127,249,0.6191744340878829,0.6191170212765957,0.6191170212765957
7,1,41,0.6004784688995215,0.6426426426426426,0.6783783783783783,0.5616797900262467,0.6370558375634517,0.5994397759103641,370,381,214,167,119,251,0.6191744340878829,0.6200290842023125,0.6200290842023125
7,1,42,0.5907990314769975,0.6242603550295858,0.6576819407008087,0.5552631578947368,0.6224489795918368,0.5877437325905291,371,380,211,169,127,244,0.6058588548601864,0.6064725492977727,0.6064725492977727
7,1,43,0.6610169491525424,0.6804733727810651,0.7165354330708661,0.6216216216216216,0.6876574307304785,0.6497175141242938,381,370,230,140,108,273,0.6697736351531292,0.6690785273462438,0.6690785273462438
7,1,44,0.6232227488151659,0.662613981762918,0.7032085561497327,0.5782493368700266,0.6608040201005025,0.6175637393767706,374,377,218,159,111,263,0.640479360852197,0.6407289465098797,0.6407289465098795
7,1,45,0.6378896882494005,0.6646706586826348,0.7037037037037037,0.5951742627345844,0.669182389937107,0.6280056577086279,378,373,222,151,112,266,0.6498002663115846,0.6494389832191441,0.6494389832191441
7,1,46,0.6532663316582915,0.6458923512747875,0.6753246753246753,0.6229508196721312,0.6641123882503193,0.6342141863699582,385,366,228,138,125,260,0.6498002663115846,0.6491377474984033,0.6491377474984033
7,1,47,0.6179245283018868,0.6605504587155964,0.7024128686327078,0.5714285714285714,0.6574654956085321,0.6127659574468085,373,378,216,162,111,262,0.6364846870838882,0.6369207200306396,0.6369207200306396
7,1,48,0.6109839816933639,0.6656050955414012,0.717741935483871,0.5514511873350924,0.6600741656365884,0.603174603174603,372,379,209,170,105,267,0.6338215712383488,0.6345965614094817,0.6345965614094817
7,1,49,0.6395939086294417,0.6386554621848739,0.6614173228346457,0.6162162162162163,0.6503225806451614,0.6272352132049519,381,370,228,142,129,252,0.6391478029294274,0.638816769525431,0.6388167695254309
7,1,50,0.6507537688442211,0.6657223796033994,0.6870026525198939,0.6283422459893048,0.6683870967741936,0.6464924346629987,377,374,235,139,118,259,0.6577896138482024,0.6576724492545994,0.6576724492545993
7,1,51,0.6361256544502618,0.6395663956639567,0.6462765957446809,0.6293333333333333,0.6411609498680738,0.6344086021505376,376,375,236,139,133,243,0.6378162450066578,0.637804964539007,0.637804964539007
7,1,52,0.6148491879350348,0.640625,0.6973684210526315,0.5525606469002695,0.6535141800246609,0.5933429811866859,380,371,205,166,115,265,0.625832223701731,0.6249645339764505,0.6249645339764507
7,1,53,0.6155717761557178,0.6588235294117647,0.6856368563685636,0.5863874345549738,0.6487179487179487,0.6204986149584486,369,382,224,158,116,253,0.6351531291611185,0.6360121454617687,0.6360121454617689
7,1,54,0.5908045977011495,0.6329113924050633,0.6890080428954424,0.5291005291005291,0.636138613861386,0.5763688760806917,373,378,200,178,116,257,0.6085219707057257,0.6090542859979857,0.6090542859979857
7,1,55,0.6032482598607889,0.61875,0.680628272251309,0.5365853658536586,0.6396063960639607,0.574746008708273,382,369,198,171,122,260,0.6098535286284953,0.6086068190524838,0.6086068190524837
7,1,56,0.6540404040404041,0.6647887323943662,0.6851851851851852,0.6327077747989276,0.6692506459948321,0.6483516483516483,378,373,236,137,119,259,0.6591211717709721,0.6589464799920564,0.6589464799920564
7,1,57,0.6252983293556086,0.641566265060241,0.6876640419947506,0.5756756756756757,0.655,0.6068376068376068,381,370,213,157,119,262,0.6324900133155792,0.6316698588352131,0.6316698588352132
7,1,58,0.6222222222222222,0.6416184971098265,0.6702127659574468,0.592,0.6453265044814341,0.6158113730929264,376,375,222,153,124,252,0.6311584553928096,0.6311063829787235,0.6311063829787235
7,1,59,0.6148325358851675,0.6606606606606606,0.6945945945945946,0.5774278215223098,0.652284263959391,0.6162464985994399,370,381,220,161,113,257,0.6351531291611185,0.6360112080584521,0.6360112080584522
7,1,60,0.6090047393364929,0.6443768996960486,0.6871657754010695,0.5623342175066313,0.6457286432160804,0.6005665722379603,374,377,212,165,117,257,0.6245006657789614,0.6247499964538503,0.6247499964538504
7,1,61,0.5763888888888888,0.6269592476489029,0.6766304347826086,0.5221932114882507,0.6224999999999999,0.5698005698005699,368,383,200,183,119,249,0.5978695073235686,0.5994118231354296,0.5994118231354296
7,1,62,0.6277372262773723,0.6647058823529411,0.6935483870967742,0.5963060686015831,0.6590038314176245,0.6286509040333796,372,379,226,153,114,258,0.644474034620506,0.6449272278491787,0.6449272278491788
7,1,63,0.6096385542168675,0.6428571428571429,0.67828418230563,0.5714285714285714,0.6421319796954315,0.6050420168067226,373,378,216,162,120,253,0.6245006657789614,0.6248563768671007,0.6248563768671007
7,1,64,0.6403061224489796,0.6545961002785515,0.6693333333333333,0.625,0.6544980443285527,0.6394557823129252,375,376,235,141,124,251,0.6471371504660453,0.6471666666666667,0.6471666666666667
7,1,65,0.6354679802955665,0.6579710144927536,0.6861702127659575,0.6053333333333333,0.6598465473145779,0.6305555555555556,376,375,227,148,118,258,0.6458055925432756,0.6457517730496453,0.6457517730496454
7,1,66,0.6174334140435835,0.6420118343195266,0.6781914893617021,0.5786666666666667,0.6463878326996197,0.608695652173913,376,375,217,158,121,255,0.6284953395472703,0.6284290780141845,0.6284290780141845
7,1,67,0.6157635467980296,0.6405797101449275,0.6684491978609626,0.5862068965517241,0.6410256410256411,0.6121883656509695,374,377,221,156,124,250,0.6271637816245007,0.6273280472063434,0.6273280472063433
7,1,68,0.6481012658227848,0.6544943820224719,0.6754617414248021,0.6263440860215054,0.6614987080103358,0.6401098901098901,379,372,233,139,123,256,0.6511318242343542,0.6509029137231538,0.6509029137231537
7,1,69,0.648578811369509,0.6483516483516484,0.662269129287599,0.6344086021505376,0.6553524804177545,0.641304347826087,379,372,236,136,128,251,0.6484687083888149,0.6483388657190683,0.6483388657190683
7,1,70,0.654639175257732,0.6363636363636364,0.6580310880829016,0.6328767123287671,0.6563307493540051,0.6346153846153846,386,365,231,134,132,254,0.6458055925432756,0.6454539002058344,0.6454539002058344
7,1,71,0.6175,0.6381766381766382,0.660427807486631,0.5941644562334217,0.6382428940568476,0.6153846153846153,374,377,224,153,127,247,0.6271637816245007,0.6272961318600263,0.6272961318600264
7,1,72,0.6433915211970075,0.6457142857142857,0.675392670157068,0.6124661246612466,0.6590038314176244,0.6286509040333798,382,369,226,143,124,258,0.644474034620506,0.6439293974091573,0.6439293974091573
7,1,73,0.6205250596658711,0.6596385542168675,0.6970509383378016,0.5793650793650794,0.6565656565656566,0.6169014084507043,373,378,219,159,113,260,0.6378162450066578,0.6382080088514404,0.6382080088514406
7,1,74,0.6191646191646192,0.627906976744186,0.6631578947368421,0.5822102425876011,0.6404066073697586,0.6041958041958041,380,371,216,155,128,252,0.6231691078561917,0.6226840686622215,0.6226840686622216
7,1,75,0.6167076167076168,0.6308139534883721,0.6640211640211641,0.5817694369973191,0.6394904458598726,0.605299860529986,378,373,217,156,127,251,0.6231691078561917,0.6228953005092416,0.6228953005092415
7,1,76,0.6214285714285714,0.6465256797583081,0.6904761904761905,0.5737265415549598,0.6541353383458647,0.6079545454545454,378,373,214,159,117,261,0.6324900133155792,0.6321013660155751,0.6321013660155751
7,1,77,0.6243386243386243,0.6058981233243967,0.6161879895561357,0.6141304347826086,0.6202365308804205,0.6099865047233468,383,368,226,142,147,236,0.6151797603195739,0.6151592121693722,0.6151592121693722
7,1,78,0.6086956521739131,0.6379821958456974,0.6737967914438503,0.5702917771883289,0.6395939086294417,0.6022408963585434,374,377,215,162,122,252,0.6218375499334221,0.6220442843160896,0.6220442843160896
7,1,79,0.6641025641025641,0.6703601108033241,0.6851851851851852,0.6487935656836461,0.6744791666666667,0.659400544959128,378,373,242,131,119,259,0.6671105193075899,0.6669893754344156,0.6669893754344156
7,1,80,0.6191646191646192,0.6540697674418605,0.6792452830188679,0.5921052631578947,0.647814910025707,0.6215469613259669,371,380,225,155,119,252,0.6351531291611185,0.6356752730883812,0.6356752730883813
7,1,81,0.6268656716417911,0.6389684813753582,0.6666666666666666,0.5978552278820375,0.6461538461538462,0.6177285318559557,378,373,223,150,126,252,0.6324900133155792,0.632260947274352,0.6322609472743522
7,1,82,0.6197530864197531,0.653179190751445,0.6765498652291105,0.5947368421052631,0.6469072164948455,0.6225895316804408,371,380,226,154,120,251,0.6351531291611185,0.6356433536671869,0.6356433536671867
7,1,83,0.6137440758293838,0.662613981762918,0.7,0.5721784776902887,0.654040404040404,0.6140845070422535,370,381,218,163,111,259,0.6351531291611185,0.6360892388451443,0.6360892388451443
7,1,84,0.616822429906542,0.6656346749226006,0.7096774193548387,0.5672823218997362,0.6599999999999999,0.6125356125356125,372,379,215,164,108,264,0.6378162450066578,0.6384798706272875,0.6384798706272875
7,1,85,0.6240786240786241,0.6395348837209303,0.671957671957672,0.5898123324396782,0.6471337579617835,0.6136680613668061,378,373,220,153,124,254,0.6311584553928096,0.6308850021986752,0.630885002198675
7,1,86,0.6311881188118812,0.6340057636887608,0.6675392670157068,0.5962059620596206,0.6488549618320609,0.6145251396648044,382,369,220,149,127,255,0.6324900133155792,0.6318726145376637,0.6318726145376637
7,1,87,0.5889145496535797,0.6446540880503144,0.6929347826086957,0.5352480417754569,0.6367041198501874,0.5848787446504993,368,383,205,178,113,255,0.6125166444740346,0.6140914121920763,0.6140914121920764
7,1,88,0.6201923076923077,0.6388059701492538,0.6807387862796834,0.5752688172043011,0.649056603773585,0.6053748231966054,379,372,214,158,121,258,0.6284953395472703,0.6280038017419922,0.6280038017419922
7,1,89,0.6407766990291263,0.6578171091445427,0.6947368421052632,0.601078167115903,0.6666666666666667,0.628169014084507,380,371,223,148,116,264,0.6484687083888149,0.6479075046105831,0.6479075046105831
7,1,90,0.6717557251908397,0.6731843575418994,0.6929133858267716,0.6513513513513514,0.6821705426356589,0.6620879120879121,381,370,241,129,117,264,0.6724367509986684,0.6721323685890616,0.6721323685890614
7,1,91,0.6228710462287105,0.6588235294117647,0.6881720430107527,0.5910290237467019,0.6538952745849298,0.6230876216968011,372,379,224,155,116,256,0.6391478029294274,0.6396005333787274,0.6396005333787272
7,1,92,0.6443914081145584,0.6897590361445783,0.7238605898123325,0.6058201058201058,0.6818181818181819,0.6450704225352114,373,378,229,149,103,270,0.6644474034620506,0.6648403478162191,0.6648403478162191
7,1,93,0.6277372262773723,0.65,0.6843501326259946,0.5909090909090909,0.6548223350253807,0.6190476190476191,377,374,221,153,119,258,0.6378162450066578,0.6376296117675427,0.6376296117675427
7,1,94,0.616822429906542,0.6594427244582043,0.7058823529411765,0.5649867374005305,0.6583541147132169,0.6085714285714285,374,377,213,164,110,264,0.6351531291611185,0.6354345451708536,0.6354345451708534
7,1,95,0.6100478468899522,0.6666666666666666,0.6967213114754098,0.5766233766233766,0.6505102040816326,0.6183844011142061,366,385,222,163,111,255,0.6351531291611185,0.6366723440493932,0.6366723440493932
7,1,96,0.6191588785046729,0.6873065015479877,0.7240437158469946,0.5766233766233766,0.6675062972292192,0.6271186440677967,366,385,222,163,101,265,0.6484687083888149,0.6503335462351856,0.6503335462351856
7,1,97,0.5995203836930456,0.6197604790419161,0.6631299734748011,0.553475935828877,0.6297229219143577,0.5847457627118644,377,374,207,167,127,250,0.6085219707057257,0.608302954651839,0.608302954651839
7,1,98,0.6376811594202898,0.658753709198813,0.6965699208443272,0.5967741935483871,0.6658259773013872,0.6262341325811002,379,372,222,150,115,264,0.6471371504660453,0.6466720571963571,0.6466720571963571
7,1,99,0.607565011820331,0.6524390243902439,0.692722371967655,0.5631578947368421,0.6473551637279598,0.6045197740112994,371,380,214,166,114,257,0.6271637816245007,0.6279401333522485,0.6279401333522485
9,1,0,0.6225961538461539,0.6597014925373135,0.6943699731903485,0.5846560846560847,0.6565272496831431,0.6199158485273493,373,378,221,157,114,259,0.6391478029294274,0.6395130289232166,0.6395130289232165
9,1,1,0.6182266009852216,0.6434782608695652,0.6711229946524064,0.5888594164456233,0.6435897435897435,0.6149584487534625,374,377,222,155,123,251,0.62982689747004,0.6299912055490149,0.6299912055490149
9,1,2,0.6097560975609756,0.6275659824046921,0.6631299734748011,0.5721925133689839,0.6353240152477765,0.5986013986013986,377,374,214,160,127,250,0.6178428761651131,0.6176612434218925,0.6176612434218925
9,1,3,0.6048780487804878,0.6334310850439883,0.6648793565683646,0.5714285714285714,0.6334610472541506,0.6008344923504867,373,378,216,162,125,248,0.6178428761651131,0.618153963998468,0.618153963998468
9,1,4,0.6105769230769231,0.6447761194029851,0.6809651474530831,0.5714285714285714,0.6438529784537389,0.605890603085554,373,378,216,162,119,254,0.625832223701731,0.6261968594408273,0.6261968594408273
9,1,5,0.6593137254901961,0.6705539358600583,0.7041884816753927,0.6233062330623306,0.6810126582278482,0.646067415730337,382,369,230,139,113,269,0.6644474034620506,0.6637473573688617,0.6637473573688617
9,1,6,0.6319612590799032,0.6745562130177515,0.7035040431266847,0.6,0.6658163265306123,0.6350974930362117,371,380,228,152,110,261,0.6511318242343542,0.6517520215633423,0.6517520215633423
9,1,7,0.6625916870415648,0.6783625730994152,0.7112860892388452,0.6270270270270271,0.6860759493670886,0.6516853932584269,381,370,232,138,110,271,0.6697736351531292,0.6691565581329362,0.6691565581329361
9,1,8,0.6146095717884131,0.6242937853107344,0.6472148541114059,0.5909090909090909,0.6304909560723515,0.6071428571428572,377,374,221,153,133,244,0.6191744340878829,0.6190619725102484,0.6190619725102483
9,1,9,0.6247086247086248,0.6708074534161491,0.7165775401069518,0.5729442970822282,0.667496886674969,0.6180257510729614,374,377,216,161,106,268,0.644474034620506,0.64476091859459,0.6447609185945901
9,1,10,0.6274038461538461,0.6537313432835821,0.6923076923076923,0.5855614973262032,0.6582597730138714,0.6177715091678421,377,374,219,155,116,261,0.6391478029294274,0.6389345948169478,0.6389345948169477
9,1,11,0.5813953488372093,0.6199376947040498,0.6720430107526881,0.525065963060686,0.6234413965087281,0.5685714285714285,372,379,199,180,122,250,0.5978695073235686,0.598554486906687,0.5985544869066871
9,1,12,0.6217494089834515,0.6829268292682927,0.7166212534059946,0.5833333333333334,0.6658227848101266,0.6292134831460675,367,384,224,160,104,263,0.6484687083888149,0.6499772933696639,0.649977293369664
9,1,13,0.657608695652174,0.6501305483028721,0.6436170212765957,0.664,0.6505376344086021,0.6569920844327178,376,375,249,126,134,242,0.6537949400798935,0.6538085106382978,0.6538085106382979
9,1,14,0.6115107913669064,0.6317365269461078,0.6746031746031746,0.5656836461126006,0.6415094339622641,0.596888260254597,378,373,211,162,123,255,0.6205059920106525,0.6201434103578876,0.6201434103578877
9,1,15,0.6253041362530414,0.6647058823529411,0.692722371967655,0.5947368421052631,0.6572890025575447,0.6277777777777778,371,380,226,154,114,257,0.6431424766977364,0.6437296070364591,0.643729607036459
9,1,16,0.6063569682151589,0.6461988304093568,0.6720867208672087,0.5785340314136126,0.6375321336760925,0.6104972375690608,369,382,221,161,121,248,0.6245006657789614,0.6253103761404106,0.6253103761404106
9,1,17,0.6149870801033591,0.6263736263736264,0.6363636363636364,0.6047745358090185,0.6254927726675427,0.6153846153846154,374,377,228,149,136,238,0.6205059920106525,0.6205690860863274,0.6205690860863274
9,1,18,0.6338383838383839,0.6338028169014085,0.6587926509186351,0.6081081081081081,0.646074646074646,0.6206896551724138,381,370,225,145,130,251,0.6338215712383488,0.6334503795133717,0.6334503795133716
9,1,19,0.6552567237163814,0.6637426900584795,0.6997389033942559,0.6168478260869565,0.6767676767676768,0.6394366197183099,383,368,227,141,115,268,0.6591211717709721,0.6582933647406062,0.6582933647406062
9,1,20,0.6200980392156863,0.6501457725947521,0.67828418230563,0.58994708994709,0.647887323943662,0.6185852981969486,373,378,223,155,120,253,0.6338215712383488,0.63411563612636,0.63411563612636
9,1,21,0.616504854368932,0.6578171091445427,0.6864864864864865,0.5853018372703412,0.6496163682864449,0.6194444444444445,370,381,223,158,116,254,0.6351531291611185,0.6358941618784139,0.6358941618784139
9,1,22,0.6214285714285714,0.6525679758308157,0.6941489361702128,0.576,0.6557788944723619,0.6118980169971672,376,375,216,159,115,261,0.6351531291611185,0.6350744680851064,0.6350744680851064
9,1,23,0.6180048661800487,0.638235294117647,0.6737400530503979,0.5802139037433155,0.6446700507614214,0.607843137254902,377,374,217,157,123,254,0.6271637816245007,0.6269769783968567,0.6269769783968566
9,1,24,0.6170731707317073,0.6422287390029325,0.6746666666666666,0.5824468085106383,0.6445859872611465,0.6108786610878661,375,376,219,157,122,253,0.6284953395472703,0.6285567375886524,0.6285567375886526
9,1,25,0.6148491879350348,0.6625,0.710455764075067,0.5608465608465608,0.6592039800995025,0.6074498567335244,373,378,212,166,108,265,0.6351531291611185,0.635651162460814,0.635651162460814
9,1,26,0.6219512195121951,0.6422287390029325,0.6763925729442971,0.5855614973262032,0.648030495552732,0.6125874125874126,377,374,219,155,122,255,0.6311584553928096,0.6309770351352502,0.63097703513525
9,1,27,0.6322115384615384,0.6805970149253732,0.7108108108108108,0.5984251968503937,0.6692111959287531,0.6368715083798883,370,381,228,153,107,263,0.6537949400798935,0.6546180038306023,0.6546180038306024
9,1,28,0.629156010230179,0.625,0.6456692913385826,0.6081081081081081,0.6373056994818652,0.6164383561643835,381,370,225,145,135,246,0.6271637816245007,0.6268886997233454,0.6268886997233454
9,1,29,0.6087962962962963,0.658307210031348,0.706989247311828,0.554089709762533,0.654228855721393,0.6017191977077363,372,379,210,169,109,263,0.62982689747004,0.6305394785371805,0.6305394785371805
9,1,30,0.6252927400468384,0.6728395061728395,0.7158176943699732,0.5767195767195767,0.6675000000000001,0.6210826210826211,373,378,218,160,106,267,0.6458055925432756,0.646268635544775,0.646268635544775
9,1,31,0.6019184652278178,0.6526946107784432,0.6839237057220708,0.5677083333333334,0.6403061224489796,0.6072423398328691,367,384,218,166,116,251,0.6245006657789614,0.625816019527702,0.6258160195277022
9,1,32,0.6163069544364509,0.6437125748502994,0.6835106382978723,0.5733333333333334,0.648171500630517,0.6064880112834978,376,375,215,160,119,257,0.6284953395472703,0.6284219858156028,0.6284219858156029
9,1,33,0.6466165413533834,0.6761363636363636,0.6935483870967742,0.6279683377308707,0.669260700389105,0.6511627906976745,372,379,238,141,114,258,0.6604527296937417,0.6607583624138225,0.6607583624138225
9,1,34,0.6492146596858639,0.6585365853658537,0.6631016042780749,0.6445623342175066,0.656084656084656,0.6514745308310992,374,377,243,134,126,248,0.6537949400798935,0.6538319692477907,0.6538319692477907
9,1,35,0.6352657004830918,0.7002967359050445,0.7225274725274725,0.6098191214470284,0.6760925449871465,0.6519337016574585,364,387,236,151,101,263,0.6644474034620506,0.6661732969872506,0.6661732969872505
9,1,36,0.6303797468354431,0.6179775280898876,0.6467532467532467,0.6010928961748634,0.6384615384615384,0.6094182825484764,385,366,220,146,136,249,0.6245006657789614,0.623923071464055,0.6239230714640551
9,1,37,0.6183574879227053,0.6201780415430267,0.6666666666666666,0.5694822888283378,0.6416040100250626,0.5937500000000001,384,367,209,158,128,256,0.6191744340878829,0.6180744777475022,0.6180744777475023
9,1,38,0.6134020618556701,0.628099173553719,0.6380697050938338,0.6031746031746031,0.6254927726675428,0.6153846153846154,373,378,228,150,135,238,0.6205059920106525,0.6206221541342185,0.6206221541342185
9,1,39,0.6322751322751323,0.6434316353887399,0.6424731182795699,0.633245382585752,0.6373333333333334,0.6382978723404256,372,379,240,139,133,239,0.6378162450066578,0.637859250432661,0.6378592504326609
9,1,40,0.6083743842364532,0.6492753623188405,0.6711956521739131,0.5848563968668408,0.6382428940568475,0.6153846153846154,368,383,224,159,121,247,0.6271637816245007,0.628026024520377,0.6280260245203769
9,1,41,0.5938242280285035,0.6242424242424243,0.6684491978609626,0.5464190981432361,0.6289308176100629,0.5827439886845827,374,377,206,171,124,250,0.607190412782956,0.6074341480020994,0.6074341480020993
9,1,42,0.6181384248210023,0.6566265060240963,0.6943699731903485,0.5767195767195767,0.6540404040404041,0.6140845070422535,373,378,218,160,114,259,0.6351531291611185,0.6355447749549626,0.6355447749549626
9,1,43,0.6207729468599034,0.658753709198813,0.6908602150537635,0.5857519788918206,0.653944020356234,0.6201117318435755,372,379,222,157,115,257,0.6378162450066578,0.6383060969727921,0.6383060969727921
9,1,44,0.6081730769230769,0.6328358208955224,0.6728723404255319,0.5653333333333334,0.6388888888888888,0.5971830985915493,376,375,212,163,123,253,0.6191744340878829,0.6191028368794327,0.6191028368794327
9,1,45,0.6745406824146981,0.6594594594594595,0.6710182767624021,0.6630434782608695,0.6727748691099477,0.6612466124661247,383,368,244,124,126,257,0.6671105193075899,0.6670308775116359,0.6670308775116358
9,1,46,0.6240601503759399,0.6335227272727273,0.6587301587301587,0.5978552278820375,0.6409266409266409,0.6151724137931035,378,373,223,150,129,249,0.6284953395472703,0.628292693306098,0.628292693306098
9,1,47,0.6134663341645885,0.6371428571428571,0.6595174262734584,0.58994708994709,0.6356589147286822,0.6126373626373627,373,378,223,155,127,246,0.6245006657789614,0.6247322581102743,0.6247322581102742
9,1,48,0.6,0.6217008797653959,0.656,0.5638297872340425,0.6267515923566879,0.5913528591352859,375,376,212,164,129,246,0.6098535286284953,0.6099148936170213,0.6099148936170212
9,1,49,0.6498740554156172,0.6581920903954802,0.6807387862796834,0.6263440860215054,0.6649484536082475,0.6418732782369145,379,372,233,139,121,258,0.6537949400798935,0.6535414361505945,0.6535414361505945
9,1,50,0.6331658291457286,0.6203966005665722,0.6528497409326425,0.6,0.6428571428571428,0.6100278551532035,386,365,219,146,134,252,0.6271637816245007,0.6264248704663213,0.6264248704663213
9,1,51,0.6326034063260341,0.65,0.6860158311345647,0.5940860215053764,0.6582278481012658,0.6207865168539326,379,372,221,151,119,260,0.640479360852197,0.6400509263199704,0.6400509263199705
9,1,52,0.6235294117647059,0.6533742331288344,0.701058201058201,0.5710455764075067,0.6600249066002492,0.6094420600858368,378,373,213,160,113,265,0.6364846870838882,0.6360518887328538,0.6360518887328539
9,1,53,0.6109839816933639,0.6528662420382165,0.7101063829787234,0.5466666666666666,0.6568265682656828,0.5950653120464441,376,375,205,170,109,267,0.6284953395472703,0.6283865248226951,0.628386524822695
9,1,54,0.6162790697674418,0.6510903426791277,0.7029177718832891,0.5588235294117647,0.6567534076827757,0.6014388489208633,377,374,209,165,112,265,0.6311584553928096,0.6308706506475269,0.6308706506475269
9,1,55,0.6168674698795181,0.6488095238095238,0.6844919786096256,0.5782493368700266,0.6489226869455007,0.6115007012622722,374,377,218,159,118,256,0.6311584553928096,0.6313706577398261,0.6313706577398261
9,1,56,0.5962877030162413,0.6375,0.6890080428954424,0.5396825396825397,0.6393034825870648,0.5845272206303723,373,378,204,174,116,257,0.6138482023968043,0.6143452912889911,0.614345291288991
9,1,57,0.619277108433735,0.6517857142857143,0.6871657754010695,0.5809018567639257,0.6514575411913814,0.6143057503506312,374,377,219,158,117,257,0.6338215712383488,0.6340338160824975,0.6340338160824976
9,1,58,0.6675324675324675,0.680327868852459,0.6871657754010695,0.6604774535809018,0.6772068511198945,0.6702557200538357,374,377,249,128,117,257,0.6737683089214381,0.6738216144909857,0.6738216144909858
9,1,59,0.6192660550458715,0.6698412698412698,0.7219251336898396,0.5596816976127321,0.6666666666666666,0.6098265895953756,374,377,211,166,104,270,0.640479360852197,0.6408034156512858,0.6408034156512858
9,1,60,0.6449086161879896,0.6358695652173914,0.6482939632545932,0.6324324324324324,0.6465968586387435,0.6341463414634146,381,370,234,136,134,247,0.640479360852197,0.6403631978435128,0.6403631978435128
9,1,61,0.6208530805687204,0.668693009118541,0.706199460916442,0.5789473684210527,0.6607818411097099,0.6205923836389281,371,380,220,160,109,262,0.6418109187749668,0.6425734146687474,0.6425734146687474
9,1,62,0.6142506142506142,0.6337209302325582,0.6648936170212766,0.5813333333333334,0.6385696040868454,0.6063977746870653,376,375,218,157,126,250,0.6231691078561917,0.6231134751773049,0.623113475177305
9,1,63,0.6586538461538461,0.6835820895522388,0.7210526315789474,0.6172506738544474,0.6884422110552765,0.6487252124645893,380,371,229,142,106,274,0.6697736351531292,0.6691516527166974,0.6691516527166974
9,1,64,0.6078886310904872,0.66875,0.7119565217391305,0.5587467362924282,0.6558197747183979,0.6088193456614508,368,383,214,169,106,262,0.6338215712383488,0.6353516290157794,0.6353516290157792
9,1,65,0.6234718826405868,0.6374269005847953,0.6728232189973615,0.5860215053763441,0.6472081218274112,0.6106442577030813,379,372,218,154,124,255,0.62982689747004,0.6294223621868528,0.6294223621868528
9,1,66,0.6132075471698113,0.654434250764526,0.6970509383378016,0.5661375661375662,0.6524466750313676,0.6070921985815603,373,378,214,164,113,260,0.6311584553928096,0.631594252237684,0.6315942522376838
9,1,67,0.6085011185682326,0.6611842105263158,0.7253333333333334,0.5345744680851063,0.661800486618005,0.5911764705882353,375,376,201,175,103,272,0.62982689747004,0.6299539007092199,0.6299539007092199
9,1,68,0.6023809523809524,0.6435045317220544,0.6819407008086253,0.5605263157894737,0.6396965865992414,0.5991561181434598,371,380,213,167,118,253,0.6205059920106525,0.6212335082990496,0.6212335082990494
9,1,69,0.6175,0.6296296296296297,0.6551724137931034,0.5909090909090909,0.6357786357786359,0.6096551724137931,377,374,221,153,130,247,0.6231691078561917,0.6230407523510971,0.6230407523510971
9,1,70,0.6179245283018868,0.6483180428134556,0.6949602122015915,0.5668449197860963,0.6541822721598003,0.6048502139800286,377,374,212,162,115,262,0.6311584553928096,0.6309025659938439,0.6309025659938439
9,1,71,0.6213151927437641,0.6774193548387096,0.732620320855615,0.5570291777188329,0.6723926380368098,0.611353711790393,374,377,210,167,100,274,0.644474034620506,0.644824749287224,0.644824749287224
9,1,72,0.6189376443418014,0.6698113207547169,0.7184986595174263,0.5634920634920635,0.6650124069478908,0.6120689655172414,373,378,213,165,105,268,0.640479360852197,0.6409953615047449,0.6409953615047449
9,1,73,0.5990990990990991,0.6710097719869706,0.7247956403269755,0.5364583333333334,0.655980271270037,0.5962373371924746,367,384,206,178,101,266,0.6284953395472703,0.6306269868301544,0.6306269868301545
9,1,74,0.6069767441860465,0.6386292834890965,0.6923076923076923,0.5481283422459893,0.6468401486988848,0.5899280575539568,377,374,205,169,116,261,0.6205059920106525,0.6202180172768408,0.6202180172768408
9,1,75,0.6291866028708134,0.6786786786786787,0.7108108108108108,0.5931758530183727,0.6675126903553299,0.6330532212885154,370,381,226,155,107,263,0.6511318242343542,0.6519933319145917,0.6519933319145919
9,1,76,0.6078431372549019,0.6268221574344023,0.6595744680851063,0.5733333333333334,0.6326530612244897,0.5988857938718664,376,375,215,160,128,248,0.6165113182423435,0.6164539007092198,0.6164539007092198
9,1,77,0.6207729468599034,0.6646884272997032,0.6945945945945946,0.5879265091863517,0.6556122448979592,0.6239554317548747,370,381,224,157,113,257,0.640479360852197,0.6412605518904732,0.6412605518904732
9,1,78,0.6018306636155606,0.6369426751592356,0.6976127320954907,0.5347593582887701,0.6461916461916463,0.5813953488372093,377,374,200,174,114,263,0.6165113182423435,0.6161860451921304,0.6161860451921304
9,1,79,0.6024096385542169,0.6279761904761905,0.6666666666666666,0.5611702127659575,0.6329113924050633,0.5926966292134832,375,376,211,165,125,250,0.6138482023968043,0.613918439716312,0.6139184397163121
9,1,80,0.6475195822454308,0.657608695652174,0.6631016042780749,0.6419098143236074,0.6552179656538969,0.6496644295302013,374,377,242,135,126,248,0.6524633821571239,0.6525057093008412,0.6525057093008411
9,1,81,0.645,0.6609686609686609,0.6843501326259946,0.6203208556149733,0.6640926640926641,0.64,377,374,232,142,119,258,0.6524633821571239,0.652335494120484,0.652335494120484
9,1,82,0.6155606407322655,0.678343949044586,0.727027027027027,0.5590551181102362,0.6666666666666667,0.6129496402877699,370,381,213,168,101,269,0.6418109187749668,0.6430410725686316,0.6430410725686316
9,1,83,0.6061320754716981,0.6513761467889908,0.692722371967655,0.5605263157894737,0.6465408805031446,0.6025459688826026,371,380,213,167,114,257,0.625832223701731,0.6266243438785644,0.6266243438785644
9,1,84,0.6098130841121495,0.6346749226006192,0.6886543535620053,0.5510752688172043,0.6468401486988848,0.5899280575539568,379,372,205,167,118,261,0.6205059920106525,0.6198648111896048,0.6198648111896048
9,1,85,0.6375321336760925,0.638121546961326,0.6543535620052771,0.6209677419354839,0.6458333333333334,0.6294277929155313,379,372,231,141,131,248,0.6378162450066578,0.6376606519703804,0.6376606519703805
9,1,86,0.6083743842364532,0.6318840579710145,0.660427807486631,0.5782493368700266,0.6333333333333334,0.6038781163434903,374,377,218,159,127,247,0.6191744340878829,0.6193385721783288,0.6193385721783288
9,1,87,0.619277108433735,0.6279761904761905,0.6727748691099477,0.5718157181571816,0.644918444165621,0.5985815602836879,382,369,211,158,125,257,0.6231691078561917,0.6222952936335646,0.6222952936335647
9,1,88,0.6083743842364532,0.6202898550724638,0.6534391534391535,0.5737265415549598,0.6301020408163265,0.596100278551532,378,373,214,159,131,247,0.6138482023968043,0.6135828474970566,0.6135828474970567
9,1,89,0.6094117647058823,0.6656441717791411,0.7038043478260869,0.566579634464752,0.6532156368221942,0.6121297602256699,368,383,217,166,109,259,0.6338215712383488,0.6351919911454195,0.6351919911454194
9,1,90,0.6424870466321243,0.6383561643835617,0.6526315789473685,0.628032345013477,0.6475195822454308,0.6331521739130435,380,371,233,138,132,248,0.640479360852197,0.6403319619804226,0.6403319619804227
9,1,91,0.6178660049627791,0.6580459770114943,0.6766304347826086,0.597911227154047,0.6459143968871595,0.6265389876880985,368,383,229,154,119,249,0.6364846870838882,0.6372708309683278,0.6372708309683277
9,1,92,0.6253164556962025,0.6376404494382022,0.6569148936170213,0.6053333333333333,0.6407263294422828,0.6210670314637482,376,375,227,148,129,247,0.6311584553928096,0.6311241134751773,0.6311241134751773
9,1,93,0.5990566037735849,0.6391437308868502,0.6827956989247311,0.5514511873350924,0.6381909547738693,0.5920679886685553,372,379,209,170,118,254,0.6165113182423435,0.6171234431299117,0.6171234431299119
9,1,94,0.6309226932668329,0.64,0.6675461741424802,0.6021505376344086,0.6487179487179487,0.6204986149584487,379,372,224,148,126,253,0.6351531291611185,0.6348483558884443,0.6348483558884443
9,1,95,0.6113861386138614,0.6253602305475504,0.6551724137931034,0.5802139037433155,0.6325224071702944,0.6019417475728155,377,374,217,157,130,247,0.6178428761651131,0.6176931587682095,0.6176931587682094
9,1,96,0.6280788177339901,0.6405797101449275,0.6728232189973615,0.5940860215053764,0.6496815286624203,0.6164574616457462,379,372,221,151,124,255,0.6338215712383488,0.6334546202513689,0.633454620251369
9,1,97,0.6373333333333333,0.6382978723404256,0.6373333333333333,0.6382978723404256,0.6373333333333333,0.6382978723404256,375,376,240,136,136,239,0.6378162450066578,0.6378156028368794,0.6378156028368794
9,1,98,0.6375321336760925,0.643646408839779,0.6578249336870027,0.6229946524064172,0.6475195822454308,0.6331521739130436,377,374,233,141,129,248,0.640479360852197,0.6404097930467099,0.6404097930467099
9,1,99,0.6291866028708134,0.6846846846846847,0.7146739130434783,0.5953002610966057,0.6692111959287532,0.6368715083798883,368,383,228,155,105,263,0.6537949400798935,0.654987087070042,0.6549870870700419
11,1,0,0.6389548693586699,0.6666666666666666,0.7097625329815304,0.5913978494623656,0.6725,0.6267806267806267,379,372,220,152,110,269,0.6511318242343542,0.650580191221948,0.6505801912219479
11,1,1,0.6508728179551122,0.66,0.6868421052631579,0.6226415094339622,0.6683738796414853,0.6407766990291262,380,371,231,140,119,261,0.6551264980026631,0.6547418073485601,0.6547418073485601
11,1,2,0.6328502415458938,0.6498516320474778,0.6894736842105263,0.5902964959568733,0.6599496221662469,0.6186440677966102,380,371,219,152,118,262,0.640479360852197,0.6398850900836999,0.6398850900836998
11,1,3,0.6726342710997443,0.6583333333333333,0.6813471502590673,0.6493150684931507,0.6769626769626771,0.6537931034482759,386,365,237,128,123,263,0.6657789613848203,0.665331109376109,0.6653311093761091
11,1,4,0.6430379746835443,0.6573033707865169,0.675531914893617,0.624,0.6588845654993514,0.640218878248974,376,375,234,141,122,254,0.6498002663115846,0.6497659574468085,0.6497659574468084
11,1,5,0.6503856041131105,0.6629834254143646,0.6746666666666666,0.6382978723404256,0.662303664921466,0.6504065040650407,375,376,240,136,122,253,0.6564580559254327,0.6564822695035462,0.6564822695035462
11,1,6,0.6339066339066339,0.6540697674418605,0.6843501326259946,0.6016042780748663,0.6581632653061225,0.6267409470752089,377,374,225,149,119,258,0.6431424766977364,0.6429772053504305,0.6429772053504305
11,1,7,0.6555819477434679,0.6757575757575758,0.720626631853786,0.6059782608695652,0.6865671641791045,0.6389684813753581,383,368,223,145,107,276,0.6644474034620506,0.6633024463616756,0.6633024463616756
11,1,8,0.6380208333333334,0.662125340599455,0.6639566395663956,0.6361256544502618,0.6507304116865869,0.6488651535380507,369,382,243,139,124,245,0.6498002663115846,0.6500411470083287,0.6500411470083287
11,1,9,0.6446700507614214,0.6694677871148459,0.6827956989247311,0.6306068601583114,0.6631853785900784,0.6494565217391304,372,379,239,140,118,254,0.6564580559254327,0.6567012795415212,0.6567012795415215
11,1,10,0.6477832512315271,0.6666666666666666,0.6957671957671958,0.6166219839142091,0.6709183673469389,0.6406685236768803,378,373,230,143,115,263,0.6564580559254327,0.6561945898407024,0.6561945898407024
11,1,11,0.6019184652278178,0.6287425149700598,0.6693333333333333,0.5585106382978723,0.6338383838383839,0.5915492957746478,375,376,210,166,124,251,0.6138482023968043,0.6139219858156029,0.6139219858156029
11,1,12,0.655,0.6695156695156695,0.6931216931216931,0.6300268096514745,0.6735218508997429,0.6491712707182321,378,373,235,138,116,262,0.6617842876165113,0.6615742513865839,0.6615742513865839
11,1,13,0.6423173803526449,0.6468926553672316,0.6710526315789473,0.6172506738544474,0.6563706563706564,0.6317241379310344,380,371,229,142,125,255,0.644474034620506,0.6441516527166974,0.6441516527166974
11,1,14,0.6255924170616114,0.668693009118541,0.707774798927614,0.582010582010582,0.6641509433962264,0.6223479490806223,373,378,220,158,109,264,0.644474034620506,0.644892690469098,0.644892690469098
11,1,15,0.6306532663316583,0.6543909348441926,0.6729222520107239,0.6111111111111112,0.6511024643320362,0.6320109439124488,373,378,231,147,122,251,0.6418109187749668,0.6420166815609176,0.6420166815609175
11,1,16,0.6197530864197531,0.6358381502890174,0.6657824933687002,0.5882352941176471,0.6419437340153452,0.611111111111111,377,374,220,154,126,251,0.6271637816245007,0.6270088937431737,0.6270088937431737
11,1,17,0.6433915211970075,0.6485714285714286,0.6771653543307087,0.6135135135135135,0.659846547314578,0.6305555555555555,381,370,227,143,123,258,0.6458055925432756,0.645339433922111,0.645339433922111
11,1,18,0.6463700234192038,0.6790123456790124,0.7263157894736842,0.5929919137466307,0.6840148698884759,0.6330935251798562,380,371,220,151,104,276,0.6604527296937417,0.6596538516101575,0.6596538516101575
11,1,19,0.6027397260273972,0.6741214057507987,0.7213114754098361,0.548051948051948,0.6567164179104478,0.6045845272206303,366,385,211,174,102,264,0.6324900133155792,0.634681711730892,0.634681711730892
11,1,20,0.619277108433735,0.6130952380952381,0.6640826873385013,0.5659340659340659,0.6408977556109726,0.5885714285714286,387,364,206,158,130,257,0.6165113182423435,0.6150083766362836,0.6150083766362836
11,1,21,0.6037735849056604,0.6299694189602446,0.6790450928381963,0.5508021390374331,0.6392009987515606,0.5877318116975748,377,374,206,168,121,256,0.6151797603195739,0.6149236159378146,0.6149236159378149
11,1,22,0.6104513064133017,0.6545454545454545,0.692722371967655,0.5684210526315789,0.648989898989899,0.6084507042253521,371,380,216,164,114,257,0.62982689747004,0.630571712299617,0.630571712299617
11,1,23,0.5990453460620525,0.6265060240963856,0.6693333333333333,0.5531914893617021,0.6322418136020151,0.5875706214689266,375,376,208,168,124,251,0.611185086551265,0.6112624113475178,0.6112624113475178
11,1,24,0.6197183098591549,0.6461538461538462,0.6965699208443272,0.5645161290322581,0.6559006211180123,0.6025824964131995,379,372,210,162,115,264,0.6311584553928096,0.6305430249382926,0.6305430249382926
11,1,25,0.6446700507614214,0.6638655462184874,0.679144385026738,0.6286472148541115,0.6614583333333334,0.6457765667574932,374,377,237,140,120,254,0.6537949400798935,0.6538957999404247,0.6538957999404247
11,1,26,0.6200980392156863,0.6326530612244898,0.6675461741424802,0.5833333333333334,0.6429479034307497,0.606993006993007,379,372,217,155,126,253,0.625832223701731,0.6254397537379067,0.6254397537379068
11,1,27,0.6168674698795181,0.6398809523809523,0.6790450928381963,0.5748663101604278,0.6464646464646465,0.6056338028169013,377,374,215,159,121,256,0.6271637816245007,0.6269557014993121,0.626955701499312
11,1,28,0.6318407960199005,0.6561604584527221,0.679144385026738,0.6074270557029178,0.654639175257732,0.6308539944903582,374,377,229,148,120,254,0.6431424766977364,0.6432857203648279,0.6432857203648279
11,1,29,0.6330935251798561,0.6736526946107785,0.707774798927614,0.5952380952380952,0.6683544303797467,0.6320224719101124,373,378,225,153,109,264,0.6511318242343542,0.6515064470828545,0.6515064470828547
11,1,30,0.6433734939759036,0.6845238095238095,0.7158176943699732,0.6084656084656085,0.6776649746192893,0.6442577030812324,373,378,230,148,106,267,0.6617842876165113,0.6621416514177909,0.6621416514177908
11,1,31,0.6228710462287105,0.65,0.6826666666666666,0.5877659574468085,0.6513994910941475,0.61731843575419,375,376,221,155,119,256,0.6351531291611185,0.6352163120567376,0.6352163120567376
11,1,32,0.6578249336870027,0.6417112299465241,0.6492146596858639,0.6504065040650406,0.6534914361001318,0.6460296096904442,382,369,240,129,134,248,0.6498002663115846,0.6498105818754523,0.6498105818754523
11,1,33,0.6443914081145584,0.6837349397590361,0.72,0.6037234042553191,0.6801007556675062,0.6412429378531073,375,376,227,149,105,270,0.6617842876165113,0.6618617021276596,0.6618617021276595
11,1,34,0.6240963855421687,0.6339285714285714,0.6780104712041884,0.5772357723577236,0.6499372647427855,0.6042553191489362,382,369,213,156,123,259,0.6284953395472703,0.627623121780956,0.627623121780956
11,1,35,0.6311688311688312,0.6366120218579235,0.6462765957446809,0.6213333333333333,0.6386333771353483,0.6288798920377868,376,375,233,142,133,243,0.6338215712383488,0.6338049645390071,0.6338049645390069
11,1,36,0.6133651551312649,0.6536144578313253,0.6908602150537635,0.5725593667546174,0.649810366624526,0.610407876230661,372,379,217,162,115,257,0.6311584553928096,0.6317097909041904,0.6317097909041904
11,1,37,0.6009389671361502,0.6430769230769231,0.6881720430107527,0.5514511873350924,0.6416040100250626,0.59375,372,379,209,170,116,256,0.6191744340878829,0.6198116151729225,0.6198116151729226
11,1,38,0.6447058823529411,0.6932515337423313,0.732620320855615,0.5994694960212201,0.685857321652065,0.6429587482219061,374,377,226,151,100,274,0.6657789613848203,0.6660449084384175,0.6660449084384176
11,1,39,0.6435643564356436,0.6685878962536023,0.6933333333333334,0.6170212765957447,0.6675224646983312,0.6417704011065007,375,376,232,144,115,260,0.6551264980026631,0.6551773049645391,0.655177304964539
11,1,40,0.6291079812206573,0.683076923076923,0.7223719676549866,0.5842105263157895,0.6725219573400252,0.6297872340425532,371,380,222,158,103,268,0.6524633821571239,0.6532912469853881,0.653291246985388
11,1,41,0.5990783410138248,0.6403785488958991,0.6951871657754011,0.5384615384615384,0.6435643564356436,0.5850144092219021,374,377,203,174,114,260,0.6165113182423435,0.6168243521184698,0.6168243521184696
11,1,42,0.6341463414634146,0.6539589442815249,0.6878306878306878,0.5978552278820375,0.6598984771573604,0.6246498599439775,378,373,223,150,118,260,0.6431424766977364,0.6428429578563627,0.6428429578563628
11,1,43,0.6078886310904872,0.653125,0.7024128686327078,0.5529100529100529,0.6517412935323382,0.5988538681948424,373,378,209,169,111,262,0.6271637816245007,0.6276614607713804,0.6276614607713804
11,1,44,0.6444444444444445,0.6791907514450867,0.7016129032258065,0.6200527704485488,0.6718146718146719,0.6482758620689655,372,379,235,144,111,261,0.6604527296937417,0.6608328368371776,0.6608328368371776
11,1,45,0.606280193236715,0.6261127596439169,0.6657824933687002,0.5641711229946524,0.6346396965865992,0.5935302390998594,377,374,211,163,126,251,0.6151797603195739,0.6149768081816763,0.6149768081816763
11,1,46,0.6292906178489702,0.6369426751592356,0.7069408740359897,0.5524861878453039,0.6658595641646489,0.591715976331361,389,362,200,162,114,275,0.6324900133155792,0.6297135309406467,0.6297135309406467
11,1,47,0.6186046511627907,0.6697819314641744,0.7150537634408602,0.5672823218997362,0.6633416458852869,0.6142857142857143,372,379,215,164,106,266,0.640479360852197,0.6411680426702983,0.6411680426702983
11,1,48,0.6345177664974619,0.6414565826330533,0.6613756613756614,0.613941018766756,0.6476683937823835,0.6273972602739725,378,373,229,144,128,250,0.6378162450066578,0.6376583400712087,0.6376583400712088
11,1,49,0.6466165413533834,0.6789772727272727,0.6954177897574124,0.6289473684210526,0.6701298701298701,0.6530054644808743,371,380,239,141,113,258,0.6617842876165113,0.6621825790892326,0.6621825790892325
11,1,50,0.5986078886310905,0.628125,0.6843501326259946,0.5374331550802139,0.6386138613861386,0.5792507204610953,377,374,201,173,119,258,0.611185086551265,0.6108916438531042,0.6108916438531042
11,1,51,0.639225181598063,0.6715976331360947,0.704,0.6037234042553191,0.6700507614213198,0.6358543417366945,375,376,227,149,111,264,0.6537949400798935,0.6538617021276596,0.6538617021276595
11,1,52,0.6506329113924051,0.6460674157303371,0.6710182767624021,0.625,0.6606683804627249,0.6353591160220994,383,368,230,138,126,257,0.6484687083888149,0.648009138381201,0.648009138381201
11,1,53,0.6367924528301887,0.7125382262996942,0.7417582417582418,0.6020671834625323,0.6852791878172588,0.6526610644257702,364,387,233,154,94,270,0.6697736351531292,0.6719127126103871,0.671912712610387
11,1,54,0.6213151927437641,0.6580645161290323,0.7210526315789474,0.5498652291105122,0.6674786845310596,0.5991189427312776,380,371,204,167,106,274,0.6364846870838882,0.6354589303447298,0.6354589303447298
11,1,55,0.5916114790286976,0.6677852348993288,0.7302452316076294,0.5182291666666666,0.6536585365853659,0.5835777126099706,367,384,199,185,99,268,0.6218375499334221,0.6242371991371481,0.624237199137148
11,1,56,0.627906976744186,0.6263736263736264,0.6411609498680739,0.6129032258064516,0.6344647519582245,0.6195652173913044,379,372,228,144,136,243,0.6271637816245007,0.6270320878372628,0.6270320878372627
11,1,57,0.647982062780269,0.6950819672131148,0.756544502617801,0.5745257452574526,0.6980676328502415,0.629080118694362,382,369,212,157,93,289,0.6671105193075899,0.6655351239376268,0.6655351239376268
11,1,58,0.6292682926829268,0.6598240469208211,0.6898395721925134,0.596816976127321,0.6581632653061225,0.6267409470752089,374,377,225,152,116,258,0.6431424766977364,0.6433282741599172,0.6433282741599171
11,1,59,0.6189320388349514,0.6460176991150443,0.68,0.5824468085106383,0.6480304955527318,0.6125874125874127,375,376,219,157,120,255,0.6311584553928096,0.6312234042553191,0.6312234042553192
11,1,60,0.6274509803921569,0.6443148688046647,0.6772486772486772,0.5924932975871313,0.6513994910941476,0.6173184357541899,378,373,221,152,122,256,0.6351531291611185,0.6348709874179043,0.6348709874179043
11,1,61,0.6246786632390745,0.6602209944751382,0.6639344262295082,0.6207792207792208,0.6437086092715232,0.6398929049531459,366,385,239,146,123,243,0.6418109187749668,0.6423568235043644,0.6423568235043645
11,1,62,0.6359338061465721,0.6646341463414634,0.7097625329815304,0.5860215053763441,0.6708229426433915,0.6228571428571429,379,372,218,154,110,269,0.6484687083888149,0.6478920191789371,0.6478920191789372
11,1,63,0.6147757255936676,0.6263440860215054,0.6263440860215054,0.6147757255936676,0.6205059920106525,0.6205059920106525,372,379,233,146,139,233,0.6205059920106525,0.6205599058075865,0.6205599058075866
11,1,64,0.647196261682243,0.6811145510835913,0.7289473684210527,0.5929919137466307,0.6856435643564357,0.6340057636887608,380,371,220,151,103,277,0.6617842876165113,0.6609696410838416,0.6609696410838416
11,1,65,0.6135265700483091,0.6468842729970327,0.6809651474530831,0.5767195767195767,0.6454891994917407,0.6097902097902098,373,378,218,160,119,254,0.6284953395472703,0.6288423620863299,0.6288423620863299
11,1,66,0.6235011990407674,0.6616766467065869,0.6970509383378016,0.5846560846560847,0.6582278481012658,0.6207865168539326,373,378,221,157,113,260,0.640479360852197,0.6408535114969431,0.6408535114969431
11,1,67,0.6166666666666667,0.6555891238670695,0.6943699731903485,0.5740740740740741,0.6532156368221943,0.61212976022567,373,378,217,161,114,259,0.6338215712383488,0.6342220236322114,0.6342220236322114
11,1,68,0.6033254156769596,0.6515151515151515,0.6883468834688347,0.56282722513089,0.6430379746835443,0.6039325842696629,369,382,215,167,115,254,0.6245006657789614,0.6255870542998624,0.6255870542998623
11,1,69,0.6175,0.6068376068376068,0.6415584415584416,0.5819672131147541,0.6292993630573249,0.5941422594142259,385,366,213,153,138,247,0.6125166444740346,0.6117628273365978,0.6117628273365978
11,1,70,0.6032482598607889,0.65,0.6989247311827957,0.5488126649076517,0.6475716064757161,0.5951359084406295,372,379,208,171,112,260,0.6231691078561917,0.6238686980452237,0.6238686980452237
11,1,71,0.639225181598063,0.6420118343195266,0.6857142857142857,0.592896174863388,0.6616541353383459,0.6164772727272727,385,366,217,149,121,264,0.640479360852197,0.6393052302888369,0.6393052302888368
11,1,72,0.6105527638190955,0.6260623229461756,0.648,0.5877659574468085,0.6287192755498061,0.6063100137174211,375,376,221,155,132,243,0.6178428761651131,0.6178829787234043,0.6178829787234043
11,1,73,0.6205250596658711,0.6355421686746988,0.6824146981627297,0.5702702702702702,0.65,0.6011396011396011,381,370,211,159,121,260,0.6271637816245007,0.6263424842165,0.6263424842165
11,1,74,0.6381418092909535,0.6812865497076024,0.7054054054054054,0.6115485564304461,0.6700898587933248,0.644536652835408,370,381,233,148,109,261,0.6577896138482024,0.6584769809179258,0.6584769809179257
11,1,75,0.6277915632754343,0.6522988505747126,0.6764705882352942,0.6021220159151194,0.6512226512226513,0.6262068965517241,374,377,227,150,121,253,0.6391478029294274,0.6392963020752068,0.6392963020752067
11,1,76,0.6280788177339901,0.6492753623188405,0.6781914893617021,0.5973333333333334,0.6521739130434782,0.6222222222222222,376,375,224,151,121,255,0.6378162450066578,0.6377624113475177,0.6377624113475178
11,1,77,0.6370192307692307,0.6597014925373135,0.6992084432717678,0.5940860215053764,0.6666666666666666,0.6251768033946253,379,372,221,151,114,265,0.6471371504660453,0.646647232388572,0.6466472323885721
11,1,78,0.620137299771167,0.6560509554140127,0.7150395778364116,0.553763440860215,0.6642156862745098,0.6005830903790087,379,372,206,166,108,271,0.6351531291611185,0.6344015093483133,0.6344015093483133
11,1,79,0.6501240694789082,0.6637931034482759,0.6912928759894459,0.6209677419354839,0.6700767263427111,0.6416666666666667,379,372,231,141,117,262,0.6564580559254327,0.6561303089624648,0.6561303089624649
11,1,80,0.6246973365617433,0.6686390532544378,0.6972972972972973,0.5931758530183727,0.6590038314176245,0.6286509040333798,370,381,226,155,112,258,0.644474034620506,0.645236575157835,0.6452365751578351
11,1,81,0.6338028169014085,0.6676923076923077,0.7142857142857143,0.5817694369973191,0.6716417910447761,0.6217765042979944,378,373,217,156,108,270,0.6484687083888149,0.6480275756415167,0.6480275756415168
11,1,82,0.6018518518518519,0.6394984326018809,0.6933333333333334,0.5425531914893617,0.644361833952912,0.5870503597122302,375,376,204,172,115,260,0.6178428761651131,0.6179432624113476,0.6179432624113474
11,1,83,0.6324582338902148,0.6566265060240963,0.6992084432717678,0.5860215053763441,0.6641604010025063,0.6193181818181818,379,372,218,154,114,265,0.6431424766977364,0.6426149743240559,0.6426149743240559
11,1,84,0.6348837209302326,0.6728971962616822,0.7222222222222222,0.579088471849866,0.6757425742574258,0.622478386167147,378,373,216,157,105,273,0.6511318242343542,0.6506553470360441,0.6506553470360441
11,1,85,0.6466346153846154,0.6686567164179105,0.7078947368421052,0.6037735849056604,0.6758793969849246,0.6345609065155807,380,371,224,147,111,269,0.6564580559254327,0.6558341608738827,0.6558341608738827
11,1,86,0.6025,0.6381766381766382,0.654891304347826,0.5848563968668408,0.6276041666666666,0.6103542234332425,368,383,224,159,127,241,0.6191744340878829,0.6198738506073335,0.6198738506073335
11,1,87,0.624390243902439,0.6539589442815249,0.6844919786096256,0.5915119363395226,0.6530612244897959,0.6211699164345404,374,377,223,154,118,256,0.6378162450066578,0.6380019574745741,0.6380019574745742
11,1,88,0.6224256292906178,0.6592356687898089,0.7176781002638523,0.5564516129032258,0.6666666666666666,0.6034985422740524,379,372,207,165,107,272,0.6378162450066578,0.637064856583539,0.637064856583539
11,1,89,0.6179245283018868,0.6636085626911316,0.7043010752688172,0.5725593667546174,0.6582914572864322,0.6147308781869689,372,379,217,162,110,262,0.6378162450066578,0.6384302210117173,0.6384302210117173
11,1,90,0.6503856041131105,0.649171270718232,0.6657894736842105,0.633423180592992,0.657997399219766,0.6412005457025921,380,371,235,136,127,253,0.6498002663115846,0.6496063271386012,0.6496063271386012
11,1,91,0.6134259259259259,0.664576802507837,0.7123655913978495,0.5593667546174143,0.6592039800995024,0.6074498567335244,372,379,212,167,107,265,0.6351531291611185,0.6358661730076319,0.6358661730076318
11,1,92,0.633177570093458,0.6656346749226006,0.7150395778364116,0.5779569892473119,0.6716232961586122,0.6187050359712231,379,372,215,157,108,271,0.6471371504660453,0.6464982835418616,0.6464982835418617
11,1,93,0.6407035175879398,0.6345609065155807,0.6640625,0.6103542234332425,0.6521739130434783,0.6222222222222222,384,367,224,143,129,255,0.6378162450066578,0.6372083617166213,0.6372083617166213
11,1,94,0.6209476309226932,0.6428571428571429,0.6657754010695187,0.596816976127321,0.6425806451612903,0.6189821182943603,374,377,225,152,125,249,0.6311584553928096,0.6312961885984198,0.6312961885984198
11,1,95,0.6116279069767442,0.6510903426791277,0.7013333333333334,0.5558510638297872,0.6534161490683229,0.5997130559540889,375,376,209,167,112,263,0.6284953395472703,0.6285921985815603,0.6285921985815603
11,1,96,0.6649484536082474,0.6804407713498623,0.6898395721925134,0.6551724137931034,0.6771653543307086,0.6675675675675675,374,377,247,130,116,258,0.6724367509986684,0.6725059929928084,0.6725059929928083
11,1,97,0.6318289786223278,0.6545454545454545,0.7,0.5822102425876011,0.6641697877652933,0.6162624821683309,380,371,216,155,114,266,0.6418109187749668,0.6411051212938005,0.6411051212938005
11,1,98,0.6027713625866051,0.6635220125786163,0.7092391304347826,0.5509138381201044,0.651685393258427,0.6019971469329529,368,383,211,172,107,261,0.6284953395472703,0.6300764842774436,0.6300764842774436
11,1,99,0.6614583333333334,0.6648501362397821,0.6737400530503979,0.6524064171122995,0.6675427069645202,0.6585695006747639,377,374,244,130,123,254,0.6631158455392809,0.6630732350813486,0.6630732350813486
13,1,0,0.6231527093596059,0.6550724637681159,0.6801075268817204,0.5963060686015831,0.6503856041131104,0.6243093922651934,372,379,226,153,119,253,0.6378162450066578,0.6382067977416517,0.6382067977416518
13,1,1,0.6271186440677966,0.6479289940828402,0.6851851851851852,0.5871313672922251,0.6548672566371682,0.6160337552742616,378,373,219,154,119,259,0.6364846870838882,0.6361582762387051,0.6361582762387051
13,1,2,0.6097560975609756,0.6392961876832844,0.6702412868632708,0.5767195767195767,0.6385696040868455,0.6063977746870655,373,378,218,160,123,250,0.6231691078561917,0.6234804317914238,0.6234804317914238
13,1,3,0.6359338061465721,0.6737804878048781,0.7154255319148937,0.5893333333333334,0.6733416770963705,0.6287339971550499,376,375,221,154,107,269,0.6524633821571239,0.6523794326241135,0.6523794326241135
13,1,4,0.6441102756892231,0.65625,0.6798941798941799,0.6193029490616622,0.6615186615186616,0.6372413793103447,378,373,231,142,121,257,0.6498002663115846,0.649598564477921,0.6495985644779211
13,1,5,0.6395061728395062,0.661849710982659,0.6888297872340425,0.6106666666666667,0.6632522407170295,0.6352288488210819,376,375,229,146,117,259,0.6498002663115846,0.6497482269503546,0.6497482269503546
13,1,6,0.6446078431372549,0.6763848396501457,0.7032085561497327,0.6153846153846154,0.6726342710997443,0.6444444444444444,374,377,232,145,111,263,0.6591211717709721,0.659296585767174,0.659296585767174
13,1,7,0.630272952853598,0.6609195402298851,0.6827956989247311,0.6068601583113457,0.6554838709677419,0.6327372764786796,372,379,230,149,118,254,0.644474034620506,0.6448279286180383,0.6448279286180384
13,1,8,0.6018099547511312,0.6763754045307443,0.726775956284153,0.5428571428571428,0.6584158415841583,0.6023054755043227,366,385,209,176,100,266,0.6324900133155792,0.634816549570648,0.6348165495706478
13,1,9,0.6228710462287105,0.6647058823529411,0.6918918918918919,0.5931758530183727,0.6555697823303457,0.6269070735090153,370,381,226,155,114,256,0.6418109187749668,0.6425338724551323,0.6425338724551324
13,1,10,0.6519721577726219,0.6875,0.7375328083989501,0.5945945945945946,0.6921182266009852,0.6376811594202898,381,370,220,150,100,281,0.6671105193075899,0.6660637014967723,0.6660637014967723
13,1,11,0.6462765957446809,0.648,0.648,0.6462765957446809,0.6471371504660454,0.6471371504660454,375,376,243,133,132,243,0.6471371504660453,0.6471382978723403,0.6471382978723405
13,1,12,0.6619385342789598,0.6890243902439024,0.7329842931937173,0.6124661246612466,0.6956521739130435,0.648493543758967,382,369,226,143,102,280,0.6737683089214381,0.672725208927482,0.6727252089274819
13,1,13,0.6346604215456675,0.6790123456790124,0.7226666666666667,0.5851063829787234,0.6758104738154614,0.6285714285714286,375,376,220,156,104,271,0.6537949400798935,0.653886524822695,0.653886524822695
13,1,14,0.6399026763990268,0.6470588235294118,0.6866840731070496,0.5978260869565217,0.6624685138539043,0.6214689265536723,383,368,220,148,120,263,0.6431424766977364,0.6422550800317857,0.6422550800317857
13,1,15,0.6036446469248291,0.6666666666666666,0.7181571815718157,0.5445026178010471,0.655940594059406,0.5994236311239193,369,382,208,174,104,265,0.62982689747004,0.6313298996864315,0.6313298996864315
13,1,16,0.6262626262626263,0.6507042253521127,0.6666666666666666,0.6094986807387863,0.6458333333333334,0.6294277929155313,372,379,231,148,124,248,0.6378162450066578,0.6380826737027265,0.6380826737027266
13,1,17,0.6229116945107399,0.6506024096385542,0.6923076923076923,0.5775401069518716,0.6557788944723617,0.6118980169971671,377,374,216,158,116,261,0.6351531291611185,0.6349238996297819,0.634923899629782
13,1,18,0.634090909090909,0.6655948553054662,0.7284595300261096,0.5625,0.678007290400972,0.609720176730486,383,368,207,161,104,279,0.6471371504660453,0.6454797650130548,0.6454797650130548
13,1,19,0.6301703163017032,0.6794117647058824,0.7038043478260869,0.6031331592689295,0.6649550706033376,0.6390041493775934,368,383,231,152,109,259,0.6524633821571239,0.6534687535475082,0.6534687535475082
13,1,20,0.5875831485587583,0.6433333333333333,0.7123655913978495,0.5092348284960422,0.643985419198056,0.5684830633284241,372,379,193,186,107,265,0.6098535286284953,0.6108002099469458,0.6108002099469458
13,1,21,0.6410891089108911,0.6570605187319885,0.6851851851851852,0.6112600536193029,0.6624040920716112,0.6333333333333333,378,373,228,145,119,259,0.6484687083888149,0.648222619402244,0.648222619402244
13,1,22,0.6379310344827587,0.6753623188405797,0.6981132075471698,0.6131578947368421,0.6666666666666667,0.6427586206896552,371,380,233,147,112,259,0.6551264980026631,0.655635551142006,0.655635551142006
13,1,23,0.6521739130434783,0.6416666666666667,0.6640625,0.6294277929155313,0.6580645161290323,0.6354883081155434,384,367,231,136,129,255,0.6471371504660453,0.6467451464577657,0.6467451464577656
13,1,24,0.6130653266331658,0.6487252124645893,0.6630434782608695,0.597911227154047,0.6370757180156659,0.6222826086956521,368,383,229,154,124,244,0.62982689747004,0.6304773527074583,0.6304773527074583
13,1,25,0.6222222222222222,0.6502890173410405,0.675603217158177,0.5952380952380952,0.647814910025707,0.6215469613259668,373,378,225,153,121,252,0.6351531291611185,0.6354206561981361,0.6354206561981361
13,1,26,0.6314496314496314,0.6395348837209303,0.6745406824146981,0.5945945945945946,0.6522842639593908,0.6162464985994398,381,370,220,150,124,257,0.6351531291611185,0.6345676385046463,0.6345676385046465
13,1,27,0.6231527093596059,0.6376811594202898,0.6693121693121693,0.5898123324396782,0.645408163265306,0.6128133704735376,378,373,220,153,125,253,0.62982689747004,0.6295622508759238,0.6295622508759238
13,1,28,0.6209302325581395,0.6697819314641744,0.7158176943699732,0.5687830687830688,0.6650062266500623,0.6151645207439199,373,378,215,163,106,267,0.6418109187749668,0.642300381576521,0.642300381576521
13,1,29,0.6379746835443038,0.6404494382022472,0.6631578947368421,0.6145552560646901,0.6503225806451612,0.6272352132049519,380,371,228,143,128,252,0.6391478029294274,0.638856575400766,0.6388565754007661
13,1,30,0.6437659033078881,0.6536312849162011,0.6710875331564987,0.6256684491978609,0.6571428571428573,0.639344262295082,377,374,234,140,124,253,0.6484687083888149,0.6483779911771799,0.6483779911771798
13,1,31,0.6166281755196305,0.6352201257861635,0.6971279373368147,0.5489130434782609,0.6544117647058824,0.5889212827988338,383,368,202,166,116,267,0.6245006657789614,0.6230204904075378,0.6230204904075377
13,1,32,0.6256281407035176,0.6288951841359773,0.6552631578947369,0.5983827493261455,0.640102827763496,0.6132596685082873,380,371,222,149,131,249,0.6271637816245007,0.6268229536104413,0.626822953610441
13,1,33,0.642512077294686,0.6824925816023739,0.7131367292225201,0.6084656084656085,0.6759847522236341,0.6433566433566433,373,378,230,148,107,266,0.6604527296937417,0.6608011688440644,0.6608011688440643
13,1,34,0.6456310679611651,0.6637168141592921,0.7,0.6064690026954178,0.6717171717171716,0.6338028169014086,380,371,225,146,114,266,0.6537949400798935,0.6532345013477089,0.6532345013477089
13,1,35,0.62,0.6381766381766382,0.6613333333333333,0.5957446808510638,0.6399999999999999,0.6162310866574965,375,376,224,152,127,248,0.6284953395472703,0.6285390070921986,0.6285390070921986
13,1,36,0.6258992805755396,0.6497005988023952,0.6904761904761905,0.5817694369973191,0.6566037735849057,0.613861386138614,378,373,217,156,117,261,0.6364846870838882,0.6361228137367547,0.6361228137367548
13,1,37,0.6212471131639723,0.6477987421383647,0.7060367454068242,0.5567567567567567,0.6609336609336609,0.5988372093023255,381,370,206,164,112,269,0.6324900133155792,0.6313967510817904,0.6313967510817905
13,1,38,0.6520681265206812,0.6764705882352942,0.708994708994709,0.6166219839142091,0.6793409378960709,0.6451612903225806,378,373,230,143,110,268,0.6631158455392809,0.662808346454459,0.6628083464544591
13,1,39,0.6726804123711341,0.6528925619834711,0.6744186046511628,0.6510989010989011,0.6735483870967741,0.6519944979367263,387,364,237,127,126,261,0.6631158455392809,0.6627587528750319,0.6627587528750319
13,1,40,0.656934306569343,0.6852941176470588,0.7161803713527851,0.6229946524064172,0.6852791878172588,0.6526610644257703,377,374,233,141,107,270,0.6697736351531292,0.6695875118796011,0.6695875118796012
13,1,41,0.6183574879227053,0.6350148367952523,0.6754617414248021,0.5752688172043011,0.6456494325346784,0.6036671368124119,379,372,214,158,123,256,0.625832223701731,0.6253652793145515,0.6253652793145515
13,1,42,0.6274509803921569,0.6763848396501457,0.6975476839237057,0.6041666666666666,0.6606451612903225,0.6382393397524071,367,384,232,152,111,256,0.6498002663115846,0.6508571752951862,0.6508571752951862
13,1,43,0.6502463054187192,0.6811594202898551,0.7058823529411765,0.623342175066313,0.676923076923077,0.6509695290858726,374,377,235,142,110,264,0.6644474034620506,0.6646122640037448,0.6646122640037446
13,1,44,0.6278538812785388,0.670926517571885,0.7275132275132276,0.5630026809651475,0.6740196078431372,0.6122448979591838,378,373,210,163,103,275,0.6458055925432756,0.6452579542391874,0.6452579542391874
13,1,45,0.6244343891402715,0.6763754045307443,0.7340425531914894,0.5573333333333333,0.6748166259168704,0.6111111111111112,376,375,209,166,100,276,0.6458055925432756,0.6456879432624113,0.6456879432624113
13,1,46,0.6032110091743119,0.6507936507936508,0.7050938337801609,0.5423280423280423,0.650185414091471,0.5916305916305917,373,378,205,173,110,263,0.6231691078561917,0.6237109380541016,0.6237109380541016
13,1,47,0.6096385542168675,0.6369047619047619,0.6746666666666666,0.5691489361702128,0.640506329113924,0.601123595505618,375,376,214,162,122,253,0.6218375499334221,0.6219078014184397,0.6219078014184397
13,1,48,0.6314553990610329,0.6430769230769231,0.6987012987012987,0.5710382513661202,0.6633785450061652,0.6049204052098408,385,366,209,157,116,269,0.6364846870838882,0.6348697750337094,0.6348697750337093
13,1,49,0.6626794258373205,0.6966966966966966,0.7328042328042328,0.6219839142091153,0.6959798994974874,0.6572237960339943,378,373,232,141,101,277,0.677762982689747,0.677394073506674,0.677394073506674
13,1,50,0.6397058823529411,0.6909620991253644,0.7111716621253406,0.6171875,0.6735483870967741,0.6519944979367264,367,384,237,147,106,261,0.6631158455392809,0.6641795810626703,0.6641795810626703
13,1,51,0.6320987654320988,0.6560693641618497,0.6826666666666666,0.6037234042553191,0.6564102564102564,0.628808864265928,375,376,227,149,119,256,0.6431424766977364,0.6431950354609929,0.6431950354609928
13,1,52,0.6096997690531177,0.6446540880503144,0.7002652519893899,0.5481283422459893,0.6518518518518518,0.5924855491329479,377,374,205,169,113,264,0.6245006657789614,0.6241967971176896,0.6241967971176896
13,1,53,0.635036496350365,0.6441176470588236,0.6832460732984293,0.5934959349593496,0.6582597730138714,0.617771509167842,382,369,219,150,121,261,0.6391478029294274,0.6383710041288895,0.6383710041288895
13,1,54,0.6433915211970075,0.6428571428571429,0.6736292428198434,0.6114130434782609,0.6581632653061223,0.626740947075209,383,368,225,143,125,258,0.6431424766977364,0.6425211431490521,0.6425211431490521
13,1,55,0.6330275229357798,0.6507936507936508,0.7150259067357513,0.5616438356164384,0.6715328467153285,0.6029411764705883,386,365,205,160,110,276,0.640479360852197,0.6383348711760948,0.6383348711760949
13,1,56,0.6146572104018913,0.6585365853658537,0.6989247311827957,0.5699208443271768,0.6540880503144655,0.611032531824611,372,379,216,163,112,260,0.6338215712383488,0.6344227877549863,0.6344227877549863
13,1,57,0.5981941309255079,0.6461038961038961,0.7085561497326203,0.5278514588859416,0.6487148102815177,0.581021897810219,374,377,199,178,109,265,0.6178428761651131,0.6182038043092809,0.6182038043092809
13,1,58,0.6232227488151659,0.6534954407294833,0.6976127320954907,0.5748663101604278,0.6583229036295369,0.6116642958748221,377,374,215,159,114,263,0.6364846870838882,0.6362395211279593,0.6362395211279592
13,1,59,0.6202830188679245,0.6483180428134556,0.6957671957671958,0.5683646112600537,0.655860349127182,0.6057142857142859,378,373,212,161,115,263,0.6324900133155792,0.6320659035136247,0.6320659035136247
13,1,60,0.6633416458852868,0.7028571428571428,0.7189189189189189,0.6456692913385826,0.6900129701686122,0.6730506155950753,370,381,246,135,104,266,0.681757656458056,0.6822941051287508,0.6822941051287508
13,1,61,0.6430317848410758,0.6812865497076024,0.706989247311828,0.6147757255936676,0.6734955185659411,0.6463245492371706,372,379,233,146,109,263,0.6604527296937417,0.6608824864527478,0.6608824864527478
13,1,62,0.634703196347032,0.6805111821086262,0.7354497354497355,0.5710455764075067,0.681372549019608,0.6209912536443148,378,373,213,160,100,278,0.6537949400798935,0.653247655928621,0.6532476559286211
13,1,63,0.6658227848101266,0.6657303370786517,0.6884816753926701,0.6422764227642277,0.676962676962677,0.6537931034482758,382,369,237,132,119,263,0.6657789613848203,0.6653790490784489,0.6653790490784489
13,1,64,0.6564102564102564,0.6398891966759003,0.6632124352331606,0.6328767123287671,0.6597938144329897,0.6363636363636364,386,365,231,134,130,256,0.6484687083888149,0.6480445737809639,0.6480445737809639
13,1,65,0.6144859813084113,0.6501547987616099,0.699468085106383,0.56,0.654228855721393,0.6017191977077364,376,375,210,165,113,263,0.62982689747004,0.6297340425531915,0.6297340425531915
13,1,66,0.6428571428571429,0.6666666666666666,0.6941489361702128,0.6133333333333333,0.6675191815856777,0.638888888888889,376,375,230,145,115,261,0.6537949400798935,0.653741134751773,0.653741134751773
13,1,67,0.6148491879350348,0.665625,0.7123655913978495,0.5620052770448549,0.660024906600249,0.6094420600858369,372,379,213,166,107,265,0.6364846870838882,0.6371854342213522,0.6371854342213522
13,1,68,0.6207674943566591,0.685064935064935,0.739247311827957,0.5567282321899736,0.6748466257668713,0.6142649199417759,372,379,211,168,97,275,0.6471371504660453,0.6479877720089653,0.6479877720089653
13,1,69,0.6081730769230769,0.6567164179104478,0.6875,0.5744125326370757,0.6454081632653061,0.6128133704735377,368,383,220,163,115,253,0.62982689747004,0.6309562663185379,0.6309562663185379
13,1,70,0.6474820143884892,0.6856287425149701,0.72,0.6090425531914894,0.6818181818181818,0.6450704225352113,375,376,229,147,105,270,0.6644474034620506,0.6645212765957447,0.6645212765957447
13,1,71,0.6032110091743119,0.6666666666666666,0.7146739130434783,0.5483028720626631,0.6542288557213931,0.6017191977077363,368,383,210,173,105,263,0.62982689747004,0.6314883925530708,0.6314883925530707
13,1,72,0.6213151927437641,0.6612903225806451,0.7229551451187335,0.5510752688172043,0.6682926829268292,0.6011730205278591,379,372,205,167,105,274,0.6378162450066578,0.6370152069679689,0.6370152069679689
13,1,73,0.636150234741784,0.6553846153846153,0.7075718015665796,0.5788043478260869,0.6699629171817059,0.6147186147186146,383,368,213,155,112,271,0.644474034620506,0.6431880746963332,0.6431880746963333
13,1,74,0.6197183098591549,0.6553846153846153,0.7021276595744681,0.568,0.658354114713217,0.6085714285714285,376,375,213,162,112,264,0.6351531291611185,0.6350638297872341,0.6350638297872341
13,1,75,0.6447058823529411,0.6779141104294478,0.7229551451187335,0.5940860215053764,0.6815920398009949,0.6332378223495702,379,372,221,151,105,274,0.6591211717709721,0.6585205833120549,0.658520583312055
13,1,76,0.6157407407407407,0.6614420062695925,0.7112299465240641,0.5596816976127321,0.6600496277915633,0.6063218390804598,374,377,211,166,108,266,0.6351531291611185,0.6354558220683981,0.6354558220683981
13,1,77,0.6370192307692307,0.6597014925373135,0.6992084432717678,0.5940860215053764,0.6666666666666666,0.6251768033946253,379,372,221,151,114,265,0.6471371504660453,0.646647232388572,0.6466472323885721
13,1,78,0.6675062972292192,0.6581920903954802,0.6865284974093264,0.6383561643835617,0.6768837803320562,0.6481223922114047,386,365,233,132,121,265,0.6631158455392809,0.6624423308964439,0.6624423308964441
13,1,79,0.6666666666666666,0.6569148936170213,0.6596306068601583,0.6639784946236559,0.663129973474801,0.660427807486631,379,372,247,125,129,250,0.6617842876165113,0.6618045507419072,0.6618045507419071
13,1,80,0.6247030878859857,0.6545454545454545,0.6976127320954907,0.5775401069518716,0.6591478696741855,0.6136363636363636,377,374,216,158,114,263,0.6378162450066578,0.6375764195236813,0.6375764195236813
13,1,81,0.6401985111662531,0.6695402298850575,0.6916890080428955,0.6164021164021164,0.6649484536082475,0.6418732782369145,373,378,233,145,115,258,0.6537949400798935,0.6540455622225059,0.6540455622225059
13,1,82,0.6197530864197531,0.6358381502890174,0.6657824933687002,0.5882352941176471,0.6419437340153452,0.611111111111111,377,374,220,154,126,251,0.6271637816245007,0.6270088937431737,0.6270088937431737
13,1,83,0.6625916870415648,0.6754385964912281,0.7094240837696335,0.6260162601626016,0.6852085967130216,0.6497890295358649,382,369,231,138,111,271,0.6684420772303595,0.6677201719661174,0.6677201719661175
13,1,84,0.6333333333333333,0.6465256797583081,0.6945169712793734,0.5815217391304348,0.6625155666251556,0.6123032904148784,383,368,214,154,117,266,0.6391478029294274,0.6380193552049042,0.638019355204904
13,1,85,0.6306954436450839,0.6826347305389222,0.7127371273712737,0.5968586387434555,0.6692111959287531,0.6368715083798884,369,382,228,154,106,263,0.6537949400798935,0.6547978830573646,0.6547978830573646
13,1,86,0.6691729323308271,0.6789772727272727,0.7026315789473684,0.6442048517520216,0.6854942233632862,0.661134163208852,380,371,239,132,113,267,0.6737683089214381,0.673418215349695,0.673418215349695
13,1,87,0.6352357320099256,0.6436781609195402,0.6736842105263158,0.6037735849056604,0.6538952745849297,0.6230876216968011,380,371,224,147,124,256,0.6391478029294274,0.638728897715988,0.638728897715988
13,1,88,0.6473551637279596,0.6440677966101694,0.6710182767624021,0.6195652173913043,0.658974358974359,0.631578947368421,383,368,228,140,126,257,0.6458055925432756,0.6452917470768531,0.6452917470768531
13,1,89,0.6030701754385965,0.6576271186440678,0.7313829787234043,0.5173333333333333,0.6610576923076924,0.5791044776119403,376,375,194,181,101,275,0.6245006657789614,0.6243581560283689,0.6243581560283687
13,1,90,0.6375,0.6438746438746439,0.6710526315789473,0.6091644204851752,0.6538461538461537,0.6260387811634349,380,371,226,145,125,255,0.640479360852197,0.6401085260320613,0.6401085260320613
13,1,91,0.6299019607843137,0.6676384839650146,0.692722371967655,0.6026315789473684,0.6598202824133503,0.6334716459197788,371,380,229,151,114,257,0.6471371504660453,0.6476769754575117,0.6476769754575117
13,1,92,0.6276849642004774,0.6566265060240963,0.6976127320954907,0.5828877005347594,0.6608040201005025,0.6175637393767706,377,374,218,156,114,263,0.640479360852197,0.640250216315125,0.6402502163151251
13,1,93,0.6374695863746959,0.6647058823529411,0.6968085106382979,0.6026666666666667,0.6658195679796697,0.632167832167832,376,375,226,149,114,262,0.6498002663115846,0.6497375886524823,0.6497375886524823
13,1,94,0.6292134831460674,0.6895424836601307,0.7466666666666667,0.5611702127659575,0.6829268292682926,0.6187683284457478,375,376,211,165,95,280,0.6537949400798935,0.653918439716312,0.653918439716312
13,1,95,0.6414634146341464,0.6774193548387096,0.7050938337801609,0.6111111111111112,0.6717752234993615,0.6425591098748262,373,378,231,147,110,263,0.6577896138482024,0.658102472445636,0.658102472445636
13,1,96,0.6258992805755396,0.6287425149700598,0.6779220779220779,0.5737704918032787,0.6508728179551122,0.6,385,366,210,156,124,261,0.6271637816245007,0.6258462848626782,0.6258462848626783
13,1,97,0.6346153846153846,0.6686567164179105,0.704,0.5957446808510638,0.6675094816687737,0.630098452883263,375,376,224,152,111,264,0.6498002663115846,0.6498723404255318,0.6498723404255318
13,1,98,0.6285714285714286,0.6737160120845922,0.7096774193548387,0.5883905013192612,0.6666666666666666,0.6281690140845071,372,379,223,156,108,264,0.6484687083888149,0.6490339603370499,0.64903396033705
13,1,99,0.6159250585480094,0.6790123456790124,0.7166212534059946,0.5729166666666666,0.6624685138539044,0.6214689265536723,367,384,220,164,104,263,0.6431424766977364,0.6447689600363307,0.6447689600363307
15,1,0,0.6157205240174672,0.6791808873720137,0.75,0.5306666666666666,0.6762589928057554,0.5958083832335329,376,375,199,176,94,282,0.640479360852197,0.6403333333333332,0.6403333333333333
15,1,1,0.6247139588100686,0.6687898089171974,0.7241379310344828,0.5614973262032086,0.6707616707616708,0.6104651162790697,377,374,210,164,104,273,0.6431424766977364,0.6428176286188456,0.6428176286188456
15,1,2,0.6119402985074627,0.6418338108882522,0.6630727762803235,0.5894736842105263,0.6364812419146184,0.6145404663923182,371,380,224,156,125,246,0.625832223701731,0.626273230245425,0.6262732302454248
15,1,3,0.6649874055415617,0.6666666666666666,0.6910994764397905,0.6395663956639567,0.6777920410783055,0.65283540802213,382,369,236,133,118,264,0.6657789613848203,0.6653329360518736,0.6653329360518737
15,1,4,0.6741293532338308,0.7020057306590258,0.7226666666666667,0.651595744680851,0.6975546975546976,0.6758620689655173,375,376,245,131,104,271,0.6870838881491345,0.6871312056737588,0.6871312056737588
15,1,5,0.6439024390243903,0.6480938416422287,0.6875,0.6021798365122616,0.6649874055415617,0.6242937853107345,384,367,221,146,120,264,0.6458055925432756,0.6448399182561309,0.6448399182561307
15,1,6,0.6542553191489362,0.6346666666666667,0.6422976501305483,0.6467391304347826,0.6482213438735178,0.6406460296096905,383,368,238,130,137,246,0.644474034620506,0.6445183902826653,0.6445183902826654
15,1,7,0.63,0.6467236467236467,0.6702127659574468,0.6053333333333333,0.6494845360824743,0.6253443526170798,376,375,227,148,124,252,0.6378162450066578,0.63777304964539,0.63777304964539
15,1,8,0.6484375,0.6539509536784741,0.6622340425531915,0.64,0.6552631578947369,0.646900269541779,376,375,240,135,127,249,0.6511318242343542,0.6511170212765958,0.6511170212765959
15,1,9,0.6348039215686274,0.6793002915451894,0.7018970189701897,0.6099476439790575,0.6666666666666667,0.6427586206896552,369,382,233,149,110,259,0.6551264980026631,0.6559223314746236,0.6559223314746236
15,1,10,0.631578947368421,0.6696696696696697,0.7058823529411765,0.5915119363395226,0.6666666666666667,0.6281690140845071,374,377,223,154,110,264,0.6484687083888149,0.6486971446403496,0.6486971446403493
15,1,11,0.6037735849056604,0.6330275229357798,0.6808510638297872,0.552,0.64,0.5897435897435898,376,375,207,168,120,256,0.6165113182423435,0.6164255319148937,0.6164255319148936
15,1,12,0.6187050359712231,0.6676646706586826,0.6991869918699187,0.5837696335078534,0.6564885496183206,0.6229050279329609,369,382,223,159,111,258,0.640479360852197,0.6414783126888861,0.6414783126888861
15,1,13,0.6467780429594272,0.7108433734939759,0.7384196185286104,0.6145833333333334,0.6895674300254453,0.659217877094972,367,384,236,148,96,271,0.6750998668442078,0.6765014759309719,0.676501475930972
15,1,14,0.6402877697841727,0.6766467065868264,0.712,0.601063829787234,0.6742424242424242,0.6366197183098592,375,376,226,150,108,267,0.6564580559254327,0.6565319148936171,0.656531914893617
15,1,15,0.6420047732696897,0.6897590361445783,0.7231182795698925,0.604221635883905,0.6801517067003794,0.6441631504922644,372,379,229,150,103,269,0.6631158455392809,0.6636699577268987,0.6636699577268987
15,1,16,0.6448598130841121,0.6656346749226006,0.71875,0.5858310626702997,0.6798029556650246,0.6231884057971014,384,367,215,152,108,276,0.6537949400798935,0.6522905313351498,0.6522905313351499
15,1,17,0.6425233644859814,0.6749226006191951,0.7236842105263158,0.5876010781671159,0.6806930693069307,0.6282420749279539,380,371,218,153,105,275,0.6564580559254327,0.6556426443467159,0.6556426443467158
15,1,18,0.6452442159383034,0.6629834254143646,0.6729222520107239,0.6349206349206349,0.6587926509186353,0.6486486486486486,373,378,240,138,122,251,0.6537949400798935,0.6539214434656794,0.6539214434656794
15,1,19,0.6004566210045662,0.6357827476038339,0.6976127320954907,0.5320855614973262,0.645398773006135,0.5793304221251819,377,374,199,175,114,263,0.6151797603195739,0.6148491467964086,0.6148491467964086
15,1,20,0.6175115207373272,0.6656151419558359,0.7165775401069518,0.5596816976127321,0.6633663366336634,0.6080691642651297,374,377,211,166,106,268,0.6378162450066578,0.638129618859842,0.638129618859842
15,1,21,0.6350710900473934,0.6899696048632219,0.7243243243243244,0.5958005249343832,0.6767676767676768,0.6394366197183099,370,381,227,154,102,268,0.6591211717709721,0.6600624246293538,0.6600624246293537
15,1,22,0.6209302325581395,0.660436137071651,0.7101063829787234,0.5653333333333334,0.6625310173697271,0.6091954022988506,376,375,212,163,109,267,0.6378162450066578,0.6377198581560284,0.6377198581560284
15,1,23,0.6476426799007444,0.6666666666666666,0.6923076923076923,0.6203208556149733,0.6692307692307692,0.6426592797783933,377,374,232,142,116,261,0.6564580559254327,0.6563142739613328,0.6563142739613328
15,1,24,0.6282352941176471,0.6871165644171779,0.7235772357723578,0.5863874345549738,0.672544080604534,0.6327683615819208,369,382,224,158,102,267,0.6537949400798935,0.6549823351636658,0.6549823351636658
15,1,25,0.6506024096385542,0.6755952380952381,0.712401055408971,0.6102150537634409,0.6801007556675063,0.6412429378531074,379,372,227,145,109,270,0.6617842876165113,0.661308054586206,0.661308054586206
15,1,26,0.6454767726161369,0.6812865497076024,0.707774798927614,0.6164021164021164,0.6751918158567776,0.6472222222222221,373,378,233,145,109,264,0.6617842876165113,0.6620884576648651,0.6620884576648651
15,1,27,0.6352657004830918,0.6528189910979229,0.6921052631578948,0.5929919137466307,0.6624685138539043,0.6214689265536723,380,371,220,151,117,263,0.6431424766977364,0.6425485884522628,0.6425485884522628
15,1,28,0.6280193236714976,0.6943620178041543,0.7162534435261708,0.6030927835051546,0.6692406692406693,0.6455172413793104,363,388,234,154,103,260,0.6577896138482024,0.6596731135156628,0.6596731135156627
15,1,29,0.6265664160401002,0.6477272727272727,0.6684491978609626,0.6047745358090185,0.646830530401035,0.625514403292181,374,377,228,149,124,250,0.6364846870838882,0.6366118668349906,0.6366118668349906
15,1,30,0.6319612590799032,0.665680473372781,0.6978609625668449,0.596816976127321,0.6632782719186785,0.6293706293706294,374,377,225,152,113,261,0.6471371504660453,0.647338969347083,0.647338969347083
15,1,31,0.643979057591623,0.6368563685636857,0.6473684210526316,0.633423180592992,0.6456692913385828,0.6351351351351352,380,371,235,136,134,246,0.640479360852197,0.6403958008228119,0.6403958008228118
15,1,32,0.6219512195121951,0.6480938416422287,0.68,0.5877659574468085,0.6496815286624205,0.6164574616457461,375,376,221,155,120,255,0.6338215712383488,0.6338829787234044,0.6338829787234043
15,1,33,0.6446078431372549,0.673469387755102,0.7013333333333334,0.6143617021276596,0.6717752234993615,0.6425591098748261,375,376,231,145,112,263,0.6577896138482024,0.6578475177304964,0.6578475177304965
15,1,34,0.6467780429594272,0.6837349397590361,0.7207446808510638,0.6053333333333333,0.6817610062893081,0.642149929278642,376,375,227,148,105,271,0.6631158455392809,0.6630390070921985,0.6630390070921985
15,1,35,0.6730769230769231,0.7104477611940299,0.7427055702917772,0.6363636363636364,0.7061790668348047,0.6713681241184768,377,374,238,136,97,280,0.6897470039946738,0.6895346033277068,0.6895346033277068
15,1,36,0.6231884057971014,0.6617210682492581,0.6935483870967742,0.5883905013192612,0.6564885496183207,0.6229050279329608,372,379,223,156,114,258,0.640479360852197,0.6409694442080177,0.6409694442080177
15,1,37,0.6610576923076923,0.6776119402985075,0.7180156657963447,0.6168478260869565,0.6883604505632039,0.6458036984352774,383,368,227,141,108,275,0.6684420772303595,0.6674317459416506,0.6674317459416506
15,1,38,0.6385542168674698,0.6696428571428571,0.7047872340425532,0.6,0.6700379266750948,0.6329113924050632,376,375,225,150,111,265,0.6524633821571239,0.6523936170212765,0.6523936170212766
15,1,39,0.6225490196078431,0.6501457725947521,0.679144385026738,0.5915119363395226,0.649616368286445,0.6194444444444444,374,377,223,154,120,254,0.6351531291611185,0.6353281606831302,0.6353281606831302
15,1,40,0.6519607843137255,0.6472303206997084,0.6873385012919897,0.6098901098901099,0.669182389937107,0.6280056577086279,387,364,222,142,121,266,0.6498002663115846,0.6486143055910498,0.6486143055910498
15,1,41,0.6261682242990654,0.6811145510835913,0.7223719676549866,0.5789473684210527,0.6708385481852315,0.6258890469416786,371,380,220,160,103,268,0.6498002663115846,0.6506596680380197,0.6506596680380194
15,1,42,0.6335877862595419,0.6564245810055865,0.6693548387096774,0.6200527704485488,0.6509803921568628,0.6377204884667571,372,379,235,144,123,249,0.644474034620506,0.6447038045791131,0.6447038045791131
15,1,43,0.6127562642369021,0.6891025641025641,0.7349726775956285,0.5584415584415584,0.6683229813664596,0.6169296987087518,366,385,215,170,97,269,0.644474034620506,0.6467071180185935,0.6467071180185935
15,1,44,0.6344339622641509,0.6574923547400612,0.7060367454068242,0.581081081081081,0.6683229813664596,0.6169296987087517,381,370,215,155,112,269,0.644474034620506,0.6435589132439526,0.6435589132439526
15,1,45,0.6305882352941177,0.6503067484662577,0.7015706806282722,0.5745257452574526,0.6641883519206939,0.6100719424460432,382,369,212,157,114,268,0.6391478029294274,0.6380482129428624,0.6380482129428624
15,1,46,0.6492537313432836,0.673352435530086,0.696,0.625,0.6718146718146718,0.6482758620689656,375,376,235,141,114,261,0.6604527296937417,0.6605000000000001,0.6605
15,1,47,0.625615763546798,0.6579710144927536,0.6827956989247311,0.5989445910290238,0.6529562982005142,0.6270718232044199,372,379,227,152,118,254,0.640479360852197,0.6408701449768774,0.6408701449768776
15,1,48,0.6388888888888888,0.7021943573667712,0.7439353099730458,0.5894736842105263,0.6874221668742216,0.6409155937052933,371,380,224,156,95,276,0.6657789613848203,0.6667044970917861,0.666704497091786
15,1,49,0.6440677966101694,0.6686390532544378,0.7037037037037037,0.6058981233243967,0.6725663716814159,0.6357243319268635,378,373,226,147,112,266,0.6551264980026631,0.6548009135140502,0.6548009135140502
15,1,50,0.615909090909091,0.6655948553054662,0.7226666666666667,0.550531914893617,0.6650306748466258,0.6026200873362445,375,376,207,169,104,271,0.6364846870838882,0.6365992907801418,0.6365992907801419
15,1,51,0.6142857142857143,0.6616314199395771,0.6972972972972973,0.5748031496062992,0.6531645569620252,0.6151685393258427,370,381,219,162,112,258,0.6351531291611185,0.6360502234517983,0.6360502234517982
15,1,52,0.6513317191283293,0.6568047337278107,0.6987012987012987,0.6065573770491803,0.6741854636591479,0.6306818181818182,385,366,222,144,116,269,0.6537949400798935,0.6526293378752395,0.6526293378752396
15,1,53,0.6275395033860045,0.698051948051948,0.7493261455525606,0.5657894736842105,0.683046683046683,0.625,371,380,215,165,93,278,0.6564580559254327,0.6575578096183855,0.6575578096183856
15,1,54,0.6556603773584906,0.6880733944954128,0.7315789473684211,0.6064690026954178,0.691542288557214,0.6446991404011461,380,371,225,146,102,278,0.6697736351531292,0.6690239750319195,0.6690239750319195
15,1,55,0.6075,0.6210826210826211,0.6462765957446809,0.5813333333333334,0.6262886597938144,0.6005509641873279,376,375,218,157,133,243,0.6138482023968043,0.6138049645390071,0.613804964539007
15,1,56,0.6122931442080378,0.6554878048780488,0.696236559139785,0.5672823218997362,0.6515723270440252,0.6082036775106083,372,379,215,164,113,259,0.6311584553928096,0.6317594405197606,0.6317594405197606
15,1,57,0.6567901234567901,0.6763005780346821,0.7037037037037037,0.6273458445040214,0.6794380587484036,0.6509040333796939,378,373,234,139,112,266,0.6657789613848203,0.6655247741038626,0.6655247741038626
15,1,58,0.6537530266343826,0.665680473372781,0.7049608355091384,0.6114130434782609,0.678391959798995,0.6373937677053825,383,368,225,143,113,270,0.6591211717709721,0.6581869394936997,0.6581869394936996
15,1,59,0.5735930735930735,0.6470588235294118,0.7220708446866485,0.4869791666666667,0.6393244873341375,0.5557206537890045,367,384,187,197,102,265,0.6018641810918774,0.6045250056766576,0.6045250056766577
15,1,60,0.6307692307692307,0.6232686980609419,0.643979057591623,0.6097560975609756,0.6373056994818653,0.6164383561643835,382,369,225,144,136,246,0.6271637816245007,0.6268675775762993,0.6268675775762994
15,1,61,0.6523809523809524,0.6737160120845922,0.7172774869109948,0.6043360433604336,0.6832917705735662,0.6371428571428572,382,369,223,146,108,274,0.6617842876165113,0.6608067651357142,0.6608067651357142
15,1,62,0.6480582524271845,0.6696165191740413,0.7044854881266491,0.6102150537634409,0.6750948166877371,0.6385372714486639,379,372,227,145,112,267,0.6577896138482024,0.6573502709450451,0.6573502709450451
15,1,63,0.625560538116592,0.7049180327868853,0.7560975609756098,0.56282722513089,0.6846625766871165,0.6259097525473071,369,382,215,167,90,279,0.6577896138482024,0.6594623930532499,0.6594623930532498
15,1,64,0.6410256410256411,0.6537396121883656,0.6666666666666666,0.6276595744680851,0.6535947712418301,0.6404341926729986,375,376,236,140,125,250,0.6471371504660453,0.6471631205673758,0.6471631205673759
15,1,65,0.6088992974238876,0.654320987654321,0.6989247311827957,0.5593667546174143,0.6508135168961202,0.6031294452347084,372,379,212,167,112,260,0.6284953395472703,0.629145742900105,0.6291457429001049
15,1,66,0.6430260047281324,0.6737804878048781,0.7176781002638523,0.5940860215053764,0.6783042394014963,0.6314285714285715,379,372,221,151,107,272,0.6564580559254327,0.6558820608846143,0.6558820608846144
15,1,67,0.6189427312775331,0.6902356902356902,0.7533512064343163,0.5423280423280423,0.67956469165659,0.6074074074074074,373,378,205,173,92,281,0.6471371504660453,0.6478396243811793,0.6478396243811794
15,1,68,0.6146993318485523,0.6655629139072847,0.7320954907161804,0.5374331550802139,0.6682808716707022,0.5946745562130178,377,374,201,173,101,276,0.6351531291611185,0.6347643228981971,0.6347643228981972
15,1,69,0.6311881188118812,0.6628242074927954,0.6854838709677419,0.6068601583113457,0.6572164948453608,0.6336088154269972,372,379,230,149,117,255,0.6458055925432756,0.6461720146395438,0.6461720146395438
15,1,70,0.6821917808219178,0.6632124352331606,0.6569920844327177,0.6881720430107527,0.6693548387096774,0.6754617414248022,379,372,256,116,130,249,0.6724367509986684,0.6725820637217352,0.6725820637217352
15,1,71,0.6597938144329897,0.6749311294765841,0.6844919786096256,0.649867374005305,0.6719160104986877,0.6621621621621622,374,377,245,132,118,256,0.6671105193075899,0.6671796763074653,0.6671796763074654
15,1,72,0.6352941176470588,0.6993865030674846,0.7336956521739131,0.5953002610966057,0.6809583858764187,0.6431593794076165,368,383,228,155,98,270,0.6631158455392809,0.6644979566352595,0.6644979566352595
15,1,73,0.6191588785046729,0.6687306501547987,0.7123655913978495,0.5699208443271768,0.6625000000000001,0.6153846153846154,372,379,216,163,107,265,0.640479360852197,0.6411432178625132,0.6411432178625132
15,1,74,0.6383495145631068,0.672566371681416,0.7032085561497327,0.6047745358090185,0.6692111959287531,0.6368715083798883,374,377,228,149,111,263,0.6537949400798935,0.6539915459793756,0.6539915459793755
15,1,75,0.6164705882352941,0.656441717791411,0.7005347593582888,0.5676392572944297,0.6558197747183981,0.6088193456614508,374,377,214,163,112,262,0.6338215712383488,0.6340870083263593,0.6340870083263591
15,1,76,0.6273584905660378,0.6636085626911316,0.7074468085106383,0.5786666666666667,0.665,0.6182336182336182,376,375,217,158,110,266,0.6431424766977364,0.6430567375886526,0.6430567375886524
15,1,77,0.6607142857142857,0.6713091922005571,0.6870026525198939,0.6443850267379679,0.6736020806241872,0.6575716234652115,377,374,241,133,118,259,0.6657789613848203,0.6656938396289309,0.665693839628931
15,1,78,0.5836909871244635,0.6701754385964912,0.7431693989071039,0.4961038961038961,0.6538461538461539,0.5701492537313433,366,385,191,194,94,272,0.6165113182423435,0.6196366475055,0.6196366475055
15,1,79,0.6294536817102138,0.6787878787878788,0.7142857142857143,0.5894736842105263,0.6691919191919191,0.6309859154929577,371,380,224,156,106,265,0.6511318242343542,0.6518796992481204,0.6518796992481204
15,1,80,0.5970873786407767,0.6283185840707964,0.6612903225806451,0.5620052770448549,0.6275510204081632,0.5933147632311978,372,379,213,166,126,246,0.611185086551265,0.6116477998127501,0.6116477998127502
15,1,81,0.607940446650124,0.6408045977011494,0.6621621621621622,0.5853018372703412,0.6338939197930142,0.6117969821673527,370,381,223,158,125,245,0.6231691078561917,0.6237319997162517,0.6237319997162518
15,1,82,0.604494382022472,0.6601307189542484,0.7211796246648794,0.5343915343915344,0.6577017114914426,0.5906432748538012,373,378,202,176,104,269,0.6271637816245007,0.6277855795282069,0.6277855795282069
15,1,83,0.6537530266343826,0.7041420118343196,0.7297297297297297,0.6246719160104987,0.689655172413793,0.6620305980528512,370,381,238,143,100,270,0.6764314247669774,0.6772008228701143,0.6772008228701143
15,1,84,0.6195121951219512,0.6744868035190615,0.6958904109589041,0.5958549222797928,0.6554838709677419,0.6327372764786795,365,386,230,156,111,254,0.644474034620506,0.6458726666193484,0.6458726666193484
15,1,85,0.6237864077669902,0.6548672566371682,0.6871657754010695,0.5888594164456233,0.653944020356234,0.6201117318435755,374,377,222,155,117,257,0.6378162450066578,0.6380125959233464,0.6380125959233465
15,1,86,0.6336633663366337,0.6743515850144092,0.6937669376693767,0.612565445026178,0.6623544631306598,0.6419753086419753,369,382,234,148,113,256,0.6524633821571239,0.6531661913477773,0.6531661913477774
15,1,87,0.6328502415458938,0.6468842729970327,0.6876640419947506,0.5891891891891892,0.6591194968553459,0.6166902404526167,381,370,218,152,119,262,0.6391478029294274,0.6384266155919699,0.6384266155919699
15,1,88,0.6095238095238096,0.6616314199395771,0.6956521739130435,0.5718015665796344,0.6497461928934011,0.6134453781512605,368,383,219,164,112,256,0.6324900133155792,0.633726870246339,0.633726870246339
15,1,89,0.6179245283018868,0.6666666666666666,0.706199460916442,0.5736842105263158,0.659119496855346,0.6166902404526166,371,380,218,162,109,262,0.6391478029294274,0.639941835721379,0.6399418357213789
15,1,90,0.6508313539192399,0.6818181818181818,0.7229551451187335,0.6048387096774194,0.6849999999999999,0.641025641025641,379,372,225,147,105,274,0.6644474034620506,0.6638969273980765,0.6638969273980765
15,1,91,0.6795865633074936,0.6730769230769231,0.6884816753926701,0.6639566395663956,0.6840052015604682,0.6684856753069577,382,369,245,124,119,263,0.6764314247669774,0.6762191574795329,0.6762191574795329
15,1,92,0.6157407407407407,0.6394984326018809,0.6981627296587927,0.5513513513513514,0.6543665436654367,0.5921625544267054,381,370,204,166,115,266,0.625832223701731,0.624757040505072,0.6247570405050721
15,1,93,0.6381909547738693,0.6430594900849859,0.6684210526315789,0.6118598382749326,0.6529562982005142,0.6270718232044199,380,371,227,144,126,254,0.640479360852197,0.6401404454532559,0.6401404454532559
15,1,94,0.6222222222222222,0.6445086705202312,0.672,0.5930851063829787,0.6461538461538461,0.6177285318559557,375,376,223,153,123,252,0.6324900133155792,0.6325425531914894,0.6325425531914893
15,1,95,0.6170212765957447,0.649390243902439,0.6941489361702128,0.568,0.6533166458072591,0.6059743954480796,376,375,213,162,115,261,0.6311584553928096,0.6310744680851064,0.6310744680851064
15,1,96,0.6367816091954023,0.6962025316455697,0.7426273458445041,0.582010582010582,0.6856435643564356,0.6340057636887608,373,378,220,158,96,277,0.6617842876165113,0.6623189639275431,0.662318963927543
15,1,97,0.6460396039603961,0.6570605187319885,0.6868421052631579,0.6145552560646901,0.6658163265306122,0.6350974930362117,380,371,228,143,119,261,0.6511318242343542,0.650698680663924,0.650698680663924
15,1,98,0.6440677966101694,0.6538461538461539,0.6945169712793734,0.6005434782608695,0.6683417085427136,0.6260623229461757,383,368,221,147,117,266,0.6484687083888149,0.6475302247701216,0.6475302247701213
15,1,99,0.5935334872979214,0.6383647798742138,0.6908602150537635,0.5356200527704486,0.6385093167701864,0.582496413199426,372,379,203,176,115,257,0.6125166444740346,0.6132401339121061,0.6132401339121061
17,1,0,0.6368159203980099,0.664756446991404,0.6863270777479893,0.6137566137566137,0.6606451612903226,0.6382393397524071,373,378,232,146,117,256,0.6498002663115846,0.6500418457523015,0.6500418457523015
17,1,1,0.6640625,0.667574931880109,0.6763925729442971,0.6550802139037433,0.6701708278580815,0.6612685560053981,377,374,245,129,122,255,0.6657789613848203,0.6657363934240201,0.6657363934240201
17,1,2,0.6128266033254157,0.6424242424242425,0.6861702127659575,0.5653333333333334,0.6474278544542033,0.601418439716312,376,375,212,163,118,258,0.625832223701731,0.6257517730496454,0.6257517730496454
17,1,3,0.6208425720620843,0.6933333333333334,0.7526881720430108,0.5488126649076517,0.6804374240583232,0.6126656848306333,372,379,208,171,92,280,0.6498002663115846,0.6507504184753312,0.6507504184753312
17,1,4,0.6308724832214765,0.6842105263157895,0.746031746031746,0.5576407506702413,0.6836363636363636,0.6144756277695717,378,373,208,165,96,282,0.6524633821571239,0.6518362483509936,0.6518362483509936
17,1,5,0.6557377049180327,0.6790123456790124,0.7291666666666666,0.5994550408719346,0.690505548705302,0.6367583212735167,384,367,220,147,104,280,0.6657789613848203,0.6643108537693005,0.6643108537693008
17,1,6,0.6324582338902148,0.6746987951807228,0.710455764075067,0.5925925925925926,0.6691919191919192,0.6309859154929577,373,378,224,154,108,265,0.6511318242343542,0.6515241783338298,0.6515241783338299
17,1,7,0.629976580796253,0.6759259259259259,0.7192513368983957,0.5809018567639257,0.6716604244694132,0.6248216833095578,374,377,219,158,105,269,0.6498002663115846,0.6500765968311607,0.6500765968311607
17,1,8,0.6309523809523809,0.6827794561933535,0.7162162162162162,0.5931758530183727,0.6708860759493671,0.6348314606741573,370,381,226,155,105,265,0.6537949400798935,0.6546960346172945,0.6546960346172945
17,1,9,0.6488372093023256,0.6915887850467289,0.7380952380952381,0.5951742627345844,0.6905940594059405,0.6397694524495677,378,373,222,151,99,279,0.6671105193075899,0.6666347504149113,0.6666347504149113
17,1,10,0.6407766990291263,0.6224188790560472,0.673469387755102,0.5877437325905293,0.6567164179104478,0.6045845272206304,392,359,211,148,128,264,0.6324900133155792,0.6306065601728157,0.6306065601728158
17,1,11,0.6146572104018913,0.6585365853658537,0.6989247311827957,0.5699208443271768,0.6540880503144655,0.611032531824611,372,379,216,163,112,260,0.6338215712383488,0.6344227877549863,0.6344227877549863
17,1,12,0.6276849642004774,0.677710843373494,0.7108108108108108,0.5905511811023622,0.6666666666666667,0.6311360448807855,370,381,225,156,107,263,0.6498002663115846,0.6506809959565865,0.6506809959565866
17,1,13,0.6782178217821783,0.6772334293948127,0.7098445595854922,0.6438356164383562,0.6936708860759494,0.6601123595505618,386,365,235,130,112,274,0.677762982689747,0.6768400880119241,0.6768400880119242
17,1,14,0.5791962174940898,0.6341463414634146,0.6712328767123288,0.538860103626943,0.6218274111675126,0.5826330532212886,365,386,208,178,120,245,0.6031957390146472,0.6050464901696359,0.605046490169636
17,1,15,0.6049107142857143,0.6600660066006601,0.7245989304812834,0.5305039787798409,0.6593673965936739,0.5882352941176471,374,377,200,177,103,271,0.6271637816245007,0.6275514546305622,0.6275514546305622
17,1,16,0.6217494089834515,0.6829268292682927,0.7166212534059946,0.5833333333333334,0.6658227848101266,0.6292134831460675,367,384,224,160,104,263,0.6484687083888149,0.6499772933696639,0.649977293369664
17,1,17,0.6413793103448275,0.7088607594936709,0.7520215633423181,0.5894736842105263,0.6923076923076923,0.6436781609195403,371,380,224,156,92,279,0.6697736351531292,0.6707476237764223,0.6707476237764222
17,1,18,0.634032634032634,0.6863354037267081,0.7292225201072386,0.5846560846560847,0.6783042394014963,0.6314285714285713,373,378,221,157,101,272,0.6564580559254327,0.6569393023816616,0.6569393023816616
17,1,19,0.6348039215686274,0.6763848396501457,0.7,0.6089238845144357,0.665809768637532,0.6408839779005525,370,381,232,149,111,259,0.6537949400798935,0.6544619422572179,0.6544619422572178
17,1,20,0.6177777777777778,0.6611295681063123,0.7315789473684211,0.5363881401617251,0.6698795180722892,0.5922619047619048,380,371,199,172,102,278,0.6351531291611185,0.633983543765073,0.633983543765073
17,1,21,0.6355140186915887,0.6842105263157895,0.7272727272727273,0.5862068965517241,0.6783042394014963,0.6314285714285715,374,377,221,156,102,272,0.6564580559254327,0.6567398119122257,0.6567398119122257
17,1,22,0.6104513064133017,0.6333333333333333,0.6798941798941799,0.5603217158176944,0.6433041301627034,0.5945945945945945,378,373,209,164,121,257,0.6205059920106525,0.620107947855937,0.6201079478559371
17,1,23,0.6312056737588653,0.6829268292682927,0.7196765498652291,0.5894736842105263,0.6725440806045341,0.632768361581921,371,380,224,156,104,267,0.6537949400798935,0.6545751170378777,0.6545751170378777
17,1,24,0.6516587677725119,0.6930091185410334,0.7313829787234043,0.608,0.6892230576441103,0.6477272727272727,376,375,228,147,101,275,0.6697736351531292,0.6696914893617021,0.6696914893617022
17,1,25,0.6495327102803738,0.6780185758513931,0.7277486910994765,0.5934959349593496,0.6864197530864198,0.6329479768786126,382,369,219,150,104,278,0.6617842876165113,0.660622313029413,0.6606223130294129
17,1,26,0.6130536130536131,0.6583850931677019,0.7050938337801609,0.5608465608465608,0.655860349127182,0.6057142857142856,373,378,212,166,110,263,0.6324900133155792,0.6329701973133609,0.6329701973133609
17,1,27,0.6093366093366094,0.6395348837209303,0.6666666666666666,0.5804749340369393,0.6367137355584083,0.6085753803596128,372,379,220,159,124,248,0.6231691078561917,0.6235708003518029,0.6235708003518031
17,1,28,0.6277372262773723,0.65,0.6843501326259946,0.5909090909090909,0.6548223350253807,0.6190476190476191,377,374,221,153,119,258,0.6378162450066578,0.6376296117675427,0.6376296117675427
17,1,29,0.6288416075650118,0.676829268292683,0.7150537634408602,0.5857519788918206,0.669182389937107,0.6280056577086282,372,379,222,157,106,266,0.6498002663115846,0.6504028711663404,0.6504028711663404
17,1,30,0.6261467889908257,0.6730158730158731,0.726063829787234,0.5653333333333334,0.6724137931034482,0.6144927536231883,376,375,212,163,103,273,0.6458055925432756,0.6456985815602836,0.6456985815602837
17,1,31,0.6255813953488372,0.6697819314641744,0.7173333333333334,0.5718085106382979,0.6683229813664596,0.6169296987087518,375,376,215,161,106,269,0.644474034620506,0.6445709219858156,0.6445709219858156
17,1,32,0.6538461538461539,0.6955223880597015,0.7272727272727273,0.6180371352785146,0.6886075949367088,0.6544943820224719,374,377,233,144,102,272,0.6724367509986684,0.6726549312756209,0.6726549312756209
17,1,33,0.6276849642004774,0.6746987951807228,0.7088948787061995,0.5894736842105263,0.6658227848101267,0.6292134831460674,371,380,224,156,108,263,0.6484687083888149,0.649184281458363,0.6491842814583629
17,1,34,0.6426799007444168,0.6522988505747126,0.6815789473684211,0.6118598382749326,0.6615581098339719,0.6314325452016689,380,371,227,144,121,259,0.6471371504660453,0.6467193928216769,0.6467193928216768
17,1,35,0.6282352941176471,0.6595092024539877,0.7063492063492064,0.5764075067024129,0.6650062266500624,0.6151645207439198,378,373,215,158,111,267,0.6418109187749668,0.6413783565258097,0.6413783565258097
17,1,36,0.6058558558558559,0.6384364820846905,0.7078947368421052,0.5283018867924528,0.6529126213592233,0.5781710914454277,380,371,196,175,111,269,0.6191744340878829,0.6180983118172789,0.618098311817279
17,1,37,0.6291079812206573,0.683076923076923,0.7223719676549866,0.5842105263157895,0.6725219573400252,0.6297872340425532,371,380,222,158,103,268,0.6524633821571239,0.6532912469853881,0.653291246985388
17,1,38,0.6416464891041163,0.6804733727810651,0.710455764075067,0.6084656084656085,0.6743002544529262,0.6424581005586593,373,378,230,148,108,265,0.6591211717709721,0.6594606862703377,0.6594606862703377
17,1,39,0.6119733924611973,0.6533333333333333,0.7263157894736842,0.5283018867924528,0.664259927797834,0.5842026825633384,380,371,196,175,104,276,0.6284953395472703,0.6273088381330685,0.6273088381330685
17,1,40,0.6320754716981132,0.6758409785932722,0.7165775401069518,0.5862068965517241,0.6716791979949874,0.627840909090909,374,377,221,156,106,268,0.6511318242343542,0.651392218329338,0.651392218329338
17,1,41,0.6318289786223278,0.6787878787878788,0.7150537634408602,0.5910290237467019,0.6708701134930642,0.6318758815232722,372,379,224,155,106,266,0.6524633821571239,0.653041393593781,0.653041393593781
17,1,42,0.642512077294686,0.6468842729970327,0.6909090909090909,0.5956284153005464,0.6658322903629537,0.6201991465149361,385,366,218,148,119,266,0.644474034620506,0.6432687531048187,0.6432687531048187
17,1,43,0.6617647058823529,0.673469387755102,0.7068062827225131,0.6260162601626016,0.6835443037974683,0.648876404494382,382,369,231,138,112,270,0.6671105193075899,0.6664112714425574,0.6664112714425574
17,1,44,0.5807860262008734,0.6552901023890785,0.7247956403269755,0.5,0.6448484848484848,0.5672082717872969,367,384,192,192,101,266,0.6098535286284953,0.6123978201634878,0.6123978201634878
17,1,45,0.64,0.6467236467236467,0.6736842105263158,0.6118598382749326,0.6564102564102564,0.628808864265928,380,371,227,144,124,256,0.6431424766977364,0.6427720244006242,0.6427720244006241
17,1,46,0.6601466992665037,0.6812865497076024,0.712401055408971,0.6263440860215054,0.6852791878172589,0.6526610644257703,379,372,233,139,109,270,0.6697736351531292,0.6693725707152383,0.6693725707152383
17,1,47,0.6077097505668935,0.6451612903225806,0.708994708994709,0.5361930294906166,0.6544566544566545,0.5856515373352855,378,373,200,173,110,268,0.6231691078561917,0.6225938692426628,0.6225938692426629
17,1,48,0.6232876712328768,0.6773162939297125,0.7299465240641712,0.5623342175066313,0.6724137931034483,0.6144927536231884,374,377,212,165,101,273,0.6458055925432756,0.6461403707854012,0.6461403707854012
17,1,49,0.6525,0.6723646723646723,0.6941489361702128,0.6293333333333333,0.672680412371134,0.650137741046832,376,375,236,139,115,261,0.6617842876165113,0.661741134751773,0.661741134751773
17,1,50,0.6344339622641509,0.6636085626911316,0.7097625329815304,0.5833333333333334,0.6699875466998755,0.6208869814020029,379,372,217,155,110,269,0.6471371504660453,0.6465479331574319,0.6465479331574319
17,1,51,0.6518518518518519,0.6647398843930635,0.6947368421052632,0.6199460916442049,0.6726114649681529,0.6415620641562064,380,371,230,141,116,264,0.6577896138482024,0.6573414668747339,0.6573414668747339
17,1,52,0.628175519630485,0.6729559748427673,0.723404255319149,0.5706666666666667,0.6724351050679853,0.6176046176046176,376,375,214,161,104,272,0.6471371504660453,0.6470354609929079,0.6470354609929078
17,1,53,0.6297229219143576,0.6666666666666666,0.6793478260869565,0.6161879895561357,0.6535947712418301,0.6404341926729987,368,383,236,147,118,250,0.6471371504660453,0.6477679078215461,0.6477679078215461
17,1,54,0.6261682242990654,0.6656346749226006,0.7127659574468085,0.5733333333333334,0.6666666666666666,0.6160458452722063,376,375,215,160,108,268,0.6431424766977364,0.6430496453900709,0.6430496453900709
17,1,55,0.6514423076923077,0.6925373134328359,0.7245989304812834,0.6153846153846154,0.6860759493670886,0.651685393258427,374,377,232,145,103,271,0.6697736351531292,0.6699917729329494,0.6699917729329494
17,1,56,0.6777251184834123,0.729483282674772,0.7626666666666667,0.6382978723404256,0.7176913425345044,0.6808510638297873,375,376,240,136,89,286,0.7003994673768309,0.7004822695035461,0.700482269503546
17,1,57,0.6280788177339901,0.663768115942029,0.6873315363881402,0.6026315789473684,0.6563706563706564,0.6317241379310344,371,380,229,151,116,255,0.644474034620506,0.6449815576677542,0.6449815576677543
17,1,58,0.6153846153846154,0.6708074534161491,0.7135135135135136,0.5669291338582677,0.6608260325406758,0.6145092460881935,370,381,216,165,106,264,0.6391478029294274,0.6402213236858906,0.6402213236858906
17,1,59,0.6502347417840375,0.6861538461538461,0.7308707124010554,0.5994623655913979,0.6881987577639751,0.6398852223816356,379,372,223,149,102,277,0.6657789613848203,0.6651665389962267,0.6651665389962267
17,1,60,0.6159600997506235,0.6457142857142857,0.6657681940700808,0.5947368421052631,0.6398963730569948,0.6191780821917807,371,380,226,154,124,247,0.62982689747004,0.630252518087672,0.6302525180876719
17,1,61,0.6379746835443038,0.6348314606741573,0.6596858638743456,0.6124661246612466,0.6486486486486486,0.623448275862069,382,369,226,143,130,252,0.6364846870838882,0.636075994267796,0.636075994267796
17,1,62,0.644927536231884,0.6676557863501483,0.7044854881266491,0.6048387096774194,0.6733921815889029,0.6346967559943583,379,372,225,147,112,267,0.6551264980026631,0.6546620989020342,0.6546620989020343
17,1,63,0.6480582524271845,0.672566371681416,0.7063492063492064,0.6112600536193029,0.6759493670886076,0.6404494382022471,378,373,228,145,111,267,0.6591211717709721,0.6588046299842547,0.6588046299842546
17,1,64,0.6446078431372549,0.6705539358600583,0.699468085106383,0.6133333333333333,0.6709183673469388,0.6406685236768802,376,375,230,145,113,263,0.6564580559254327,0.6564007092198582,0.6564007092198582
17,1,65,0.6220657276995305,0.6646153846153846,0.7085561497326203,0.5729442970822282,0.6625,0.6153846153846154,374,377,216,161,109,265,0.640479360852197,0.6407502234074242,0.6407502234074243
17,1,66,0.6496350364963503,0.6764705882352942,0.7082228116710876,0.6149732620320856,0.6776649746192893,0.6442577030812325,377,374,230,144,110,267,0.6617842876165113,0.6615980368515866,0.6615980368515866
17,1,67,0.6222760290556901,0.665680473372781,0.6945945945945946,0.5905511811023622,0.6564495530012772,0.6258692628650904,370,381,225,156,113,257,0.6418109187749668,0.6425728878484784,0.6425728878484783
17,1,68,0.645933014354067,0.6726726726726727,0.712401055408971,0.6021505376344086,0.6775407779171895,0.6354609929078014,379,372,224,148,109,270,0.6577896138482024,0.6572757965216898,0.6572757965216898
17,1,69,0.6264501160092807,0.696875,0.7356948228882834,0.5807291666666666,0.6766917293233082,0.6335227272727272,367,384,223,161,97,270,0.6564580559254327,0.6582119947774752,0.6582119947774749
17,1,70,0.6354916067146283,0.6676646706586826,0.7047872340425532,0.5946666666666667,0.6683480453972257,0.6290550070521862,376,375,223,152,111,265,0.6498002663115846,0.6497269503546099,0.6497269503546099
17,1,71,0.645320197044335,0.6608695652173913,0.6912928759894459,0.6129032258064516,0.6675159235668789,0.6359832635983262,379,372,228,144,117,262,0.6524633821571239,0.6520980508979487,0.6520980508979487
17,1,72,0.6270783847980997,0.6636363636363637,0.704,0.5824468085106383,0.6633165829145727,0.6203966005665723,375,376,219,157,111,264,0.6431424766977364,0.6432234042553191,0.6432234042553192
17,1,73,0.630071599045346,0.6807228915662651,0.7135135135135136,0.5931758530183727,0.6692015209125476,0.6339410939691444,370,381,226,155,106,264,0.6524633821571239,0.6533446832659431,0.6533446832659432
17,1,74,0.6071428571428571,0.6666666666666666,0.7292225201072386,0.5343915343915344,0.6626065773447015,0.5932452276064611,373,378,202,176,101,272,0.6311584553928096,0.6318070272493865,0.6318070272493865
17,1,75,0.6633906633906634,0.6802325581395349,0.7105263157894737,0.6307277628032345,0.6861499364675985,0.6545454545454545,380,371,234,137,110,270,0.6711051930758988,0.6706270392963541,0.6706270392963541
17,1,76,0.6338028169014085,0.6707692307692308,0.7161803713527851,0.5828877005347594,0.6724782067247822,0.6237482117310443,377,374,218,156,107,270,0.6498002663115846,0.6495340359437722,0.6495340359437723
17,1,77,0.604494382022472,0.6568627450980392,0.7192513368983957,0.53315649867374,0.6568986568986569,0.588579795021962,374,377,201,176,105,269,0.625832223701731,0.6262039177860679,0.6262039177860679
17,1,78,0.6299019607843137,0.673469387755102,0.6964769647696477,0.6047120418848168,0.6615186615186615,0.6372413793103447,369,382,231,151,112,257,0.6498002663115846,0.6505945033272322,0.6505945033272322
17,1,79,0.6145124716553289,0.6774193548387096,0.7304582210242587,0.5526315789473685,0.6674876847290642,0.6086956521739131,371,380,210,170,100,271,0.640479360852197,0.6415448999858135,0.6415448999858135
17,1,80,0.6355140186915887,0.7027863777089783,0.7391304347826086,0.5926892950391645,0.6834170854271356,0.6430594900849859,368,383,227,156,96,272,0.6644474034620506,0.6659098649108866,0.6659098649108866
17,1,81,0.6511056511056511,0.6744186046511628,0.7029177718832891,0.6203208556149733,0.6760204081632654,0.6462395543175486,377,374,232,142,112,265,0.6617842876165113,0.6616193137491313,0.6616193137491312
17,1,82,0.6136363636363636,0.6559485530546624,0.7161803713527851,0.5454545454545454,0.6609547123623011,0.5956204379562043,377,374,204,170,107,270,0.6311584553928096,0.6308174584036652,0.6308174584036654
17,1,83,0.6437346437346437,0.6715116279069767,0.6986666666666667,0.6143617021276596,0.670076726342711,0.6416666666666667,375,376,231,145,113,262,0.6564580559254327,0.656514184397163,0.6565141843971632
17,1,84,0.6402877697841727,0.6646706586826348,0.7044854881266491,0.5967741935483871,0.670854271356784,0.6288951841359774,379,372,222,150,112,267,0.6511318242343542,0.6506298408375182,0.6506298408375181
17,1,85,0.6239316239316239,0.7031802120141343,0.776595744680851,0.5306666666666666,0.6919431279620852,0.6048632218844986,376,375,199,176,84,292,0.6537949400798935,0.6536312056737589,0.6536312056737589
17,1,86,0.6091703056768559,0.6382252559726962,0.7246753246753247,0.5109289617486339,0.6619217081850534,0.5675265553869498,385,366,187,179,106,279,0.6205059920106525,0.6178021432119793,0.6178021432119793
17,1,87,0.6339712918660287,0.6996996996996997,0.726027397260274,0.6036269430051814,0.6768837803320562,0.6481223922114047,365,386,233,153,100,265,0.6631158455392809,0.6648271701327275,0.6648271701327276
17,1,88,0.6329411764705882,0.6748466257668712,0.7173333333333334,0.5851063829787234,0.6725000000000001,0.6267806267806268,375,376,220,156,106,269,0.6511318242343542,0.6512198581560285,0.6512198581560285
17,1,89,0.6077097505668935,0.6516129032258065,0.7127659574468085,0.5386666666666666,0.6560587515299878,0.5897810218978102,376,375,202,173,108,268,0.625832223701731,0.6257163120567376,0.6257163120567376
17,1,90,0.6423529411764706,0.6687116564417178,0.7165354330708661,0.5891891891891892,0.6774193548387096,0.6264367816091955,381,370,218,152,108,273,0.6537949400798935,0.6528623111300277,0.6528623111300278
17,1,91,0.6053215077605322,0.6666666666666666,0.7319034852546917,0.5291005291005291,0.662621359223301,0.5899705014749262,373,378,200,178,100,273,0.62982689747004,0.6305020071776104,0.6305020071776104
17,1,92,0.6451612903225806,0.694006309148265,0.7427055702917772,0.5882352941176471,0.6905055487053021,0.6367583212735166,377,374,220,154,97,280,0.6657789613848203,0.6654704322047121,0.6654704322047121
17,1,93,0.6599496221662469,0.7005649717514124,0.7119565217391305,0.6475195822454308,0.6849673202614379,0.6729986431478969,368,383,248,135,106,262,0.6790945406125166,0.6797380519922807,0.6797380519922807
17,1,94,0.6394230769230769,0.6626865671641791,0.7018469656992085,0.5967741935483871,0.6691823899371069,0.628005657708628,379,372,222,150,113,266,0.6498002663115846,0.6493105796237977,0.6493105796237977
17,1,95,0.6317073170731707,0.6363636363636364,0.6762402088772846,0.5896739130434783,0.6532156368221943,0.6121297602256699,383,368,217,151,124,259,0.6338215712383488,0.6329570609603815,0.6329570609603814
17,1,96,0.6456310679611651,0.6666666666666666,0.7018469656992085,0.6075268817204301,0.672566371681416,0.6357243319268636,379,372,226,146,113,266,0.6551264980026631,0.6546869237098193,0.6546869237098192
17,1,97,0.6178489702517163,0.6656050955414012,0.72,0.5558510638297872,0.6650246305418719,0.6057971014492753,375,376,209,167,105,270,0.6378162450066578,0.6379255319148937,0.6379255319148937
17,1,98,0.6814814814814815,0.6734104046242775,0.7095115681233933,0.643646408839779,0.6952141057934509,0.6581920903954802,389,362,233,129,113,276,0.677762982689747,0.6765789884815862,0.676578988481586
17,1,99,0.6318407960199005,0.6389684813753582,0.6684210526315789,0.601078167115903,0.649616368286445,0.6194444444444446,380,371,223,148,126,254,0.6351531291611185,0.634749609873741,0.6347496098737411
19,1,0,0.6447058823529411,0.7116564417177914,0.7445652173913043,0.6057441253263708,0.691046658259773,0.6544428772919605,368,383,232,151,94,274,0.6737683089214381,0.6751546713588374,0.6751546713588374
19,1,1,0.6313253012048192,0.6696428571428571,0.7024128686327078,0.5952380952380952,0.6649746192893401,0.6302521008403361,373,378,225,153,111,262,0.6484687083888149,0.6488254819354016,0.6488254819354016
19,1,2,0.6690821256038647,0.7091988130563798,0.7386666666666667,0.6356382978723404,0.7021546261089987,0.6704067321178121,375,376,239,137,98,277,0.6870838881491345,0.6871524822695037,0.6871524822695035
19,1,3,0.6134259259259259,0.64576802507837,0.701058201058201,0.5522788203753352,0.654320987654321,0.5953757225433527,378,373,206,167,113,265,0.6271637816245007,0.626668510716768,0.6266685107167681
19,1,4,0.6222760290556901,0.6686390532544378,0.6964769647696477,0.5916230366492147,0.6572890025575447,0.6277777777777778,369,382,226,156,112,257,0.6431424766977364,0.6440500007094312,0.6440500007094312
19,1,5,0.6354916067146283,0.6766467065868264,0.710455764075067,0.5978835978835979,0.6708860759493671,0.6348314606741572,373,378,226,152,108,265,0.6537949400798935,0.6541696809793325,0.6541696809793325
19,1,6,0.6886543535620053,0.6935483870967742,0.696,0.6861702127659575,0.6923076923076923,0.6898395721925135,375,376,258,118,114,261,0.6910785619174434,0.6910851063829787,0.6910851063829787
19,1,7,0.6300448430493274,0.6950819672131148,0.7513368983957219,0.5623342175066313,0.6853658536585366,0.6217008797653959,374,377,212,165,93,281,0.6564580559254327,0.6568355579511767,0.6568355579511765
19,1,8,0.6187050359712231,0.6586826347305389,0.6935483870967742,0.5804749340369393,0.6539923954372625,0.6171107994389903,372,379,220,159,114,258,0.6364846870838882,0.6370116605668568,0.6370116605668568
19,1,9,0.6374407582938388,0.6778115501519757,0.7173333333333334,0.5930851063829787,0.6750313676286073,0.6326241134751773,375,376,223,153,106,269,0.6551264980026631,0.6552092198581561,0.6552092198581561
19,1,10,0.6116279069767442,0.6728971962616822,0.7146739130434783,0.5639686684073107,0.6591478696741855,0.6136363636363636,368,383,216,167,105,263,0.6378162450066578,0.6393212907253945,0.6393212907253946
19,1,11,0.6717171717171717,0.676056338028169,0.6981627296587927,0.6486486486486487,0.6846846846846847,0.6620689655172414,381,370,240,130,115,266,0.6737683089214381,0.6734056891537207,0.6734056891537207
19,1,12,0.5981941309255079,0.6655844155844156,0.720108695652174,0.5352480417754569,0.6535141800246609,0.593342981186686,368,383,205,178,103,265,0.625832223701731,0.6276783687138154,0.6276783687138154
19,1,13,0.6428571428571429,0.6948640483383686,0.7277628032345014,0.6052631578947368,0.6826801517067005,0.6469760900140646,371,380,230,150,101,270,0.6657789613848203,0.6665129805646192,0.666512980564619
19,1,14,0.6547619047619048,0.6646525679758308,0.7124352331606217,0.6027397260273972,0.6823821339950372,0.632183908045977,386,365,220,145,111,275,0.6591211717709721,0.6575874795940094,0.6575874795940095
19,1,15,0.625866050808314,0.6823899371069182,0.728494623655914,0.5725593667546174,0.6732919254658385,0.6226685796269728,372,379,217,162,101,271,0.6498002663115846,0.6505269952052657,0.6505269952052657
19,1,16,0.6420047732696897,0.6897590361445783,0.7231182795698925,0.604221635883905,0.6801517067003794,0.6441631504922644,372,379,229,150,103,269,0.6631158455392809,0.6636699577268987,0.6636699577268987
19,1,17,0.6624365482233503,0.6554621848739496,0.6796875,0.6376021798365122,0.6709511568123393,0.6464088397790055,384,367,234,133,123,261,0.6591211717709721,0.6586448399182562,0.6586448399182561
19,1,18,0.6187050359712231,0.655688622754491,0.6916890080428955,0.5793650793650794,0.6531645569620252,0.6151685393258427,373,378,219,159,115,258,0.6351531291611185,0.6355270437039874,0.6355270437039875
19,1,19,0.6297229219143576,0.6468926553672316,0.6666666666666666,0.6090425531914894,0.6476683937823833,0.6273972602739726,375,376,229,147,125,250,0.6378162450066578,0.637854609929078,0.637854609929078
19,1,20,0.6116279069767442,0.6479750778816199,0.699468085106383,0.5546666666666666,0.652605459057072,0.5977011494252874,376,375,208,167,113,263,0.6271637816245007,0.6270673758865248,0.6270673758865248
19,1,21,0.6202830188679245,0.6605504587155964,0.7032085561497327,0.5729442970822282,0.6591478696741854,0.6136363636363636,374,377,216,161,111,263,0.6378162450066578,0.6380764266159803,0.6380764266159804
19,1,22,0.6376470588235295,0.6533742331288344,0.7057291666666666,0.5803814713896458,0.6699629171817059,0.6147186147186148,384,367,213,154,113,271,0.644474034620506,0.6430553190281562,0.6430553190281563
19,1,23,0.6492890995260664,0.6747720364741642,0.7191601049868767,0.6,0.6824408468244085,0.6351931330472103,381,370,222,148,107,274,0.6604527296937417,0.6595800524934383,0.6595800524934383
19,1,24,0.6404761904761904,0.6797583081570997,0.7173333333333334,0.598404255319149,0.6767295597484276,0.6364922206506364,375,376,225,151,106,269,0.6577896138482024,0.6578687943262411,0.6578687943262411
19,1,25,0.6384039900249376,0.6342857142857142,0.6666666666666666,0.6049046321525886,0.6522292993630572,0.6192468619246863,384,367,222,145,128,256,0.6364846870838882,0.6357856494096277,0.6357856494096278
19,1,26,0.6378504672897196,0.6811145510835913,0.726063829787234,0.5866666666666667,0.6791044776119404,0.6303724928366762,376,375,220,155,103,273,0.6564580559254327,0.6563652482269503,0.6563652482269504
19,1,27,0.6261904761904762,0.6586102719033232,0.699468085106383,0.5813333333333334,0.6608040201005025,0.6175637393767706,376,375,218,157,113,263,0.640479360852197,0.6404007092198581,0.6404007092198583
19,1,28,0.6463700234192038,0.6851851851851852,0.7301587301587301,0.5951742627345844,0.6857142857142858,0.6370157819225252,378,373,222,151,102,276,0.6631158455392809,0.6626664964466573,0.6626664964466573
19,1,29,0.6066666666666667,0.6710963455149501,0.7338709677419355,0.5329815303430079,0.6642335766423358,0.5941176470588235,372,379,202,177,99,273,0.6324900133155792,0.6334262490424717,0.6334262490424718
19,1,30,0.6155660377358491,0.6758409785932722,0.7111716621253406,0.5755208333333334,0.6599241466498104,0.6216596343178621,367,384,221,163,106,261,0.6418109187749668,0.6433462477293369,0.643346247729337
19,1,31,0.6195899772209568,0.6826923076923077,0.7331536388140162,0.5605263157894737,0.671604938271605,0.6156069364161849,371,380,213,167,99,272,0.6458055925432756,0.6468399773017449,0.6468399773017448
19,1,32,0.6083150984682714,0.6700680272108843,0.7413333333333333,0.523936170212766,0.6682692307692307,0.5880597014925373,375,376,197,179,97,278,0.6324900133155792,0.6326347517730496,0.6326347517730497
19,1,33,0.6164383561643836,0.6932907348242812,0.7377049180327869,0.5636363636363636,0.6716417910447762,0.6217765042979942,366,385,217,168,96,270,0.6484687083888149,0.6506706408345754,0.6506706408345752
19,1,34,0.6036866359447005,0.6246056782334385,0.6876640419947506,0.5351351351351351,0.6429447852760736,0.5764192139737991,381,370,198,172,119,262,0.6125166444740346,0.6113995885649428,0.6113995885649428
19,1,35,0.6093023255813953,0.6635514018691588,0.7081081081081081,0.5590551181102362,0.6549999999999999,0.6068376068376069,370,381,213,168,108,262,0.6324900133155792,0.6335816131091722,0.633581613109172
19,1,36,0.6674698795180722,0.7172619047619048,0.7446236559139785,0.6358839050131926,0.7039390088945362,0.6741258741258741,372,379,241,138,95,277,0.6897470039946738,0.6902537804635855,0.6902537804635855
19,1,37,0.6400966183574879,0.6884272997032641,0.7162162162162162,0.6089238845144357,0.6760204081632654,0.6462395543175488,370,381,232,149,105,265,0.6617842876165113,0.662570050365326,0.662570050365326
19,1,38,0.6094117647058823,0.6717791411042945,0.7076502732240437,0.5688311688311688,0.654867256637168,0.6160337552742616,366,385,219,166,107,259,0.6364846870838882,0.6382407210276063,0.6382407210276063
19,1,39,0.5982532751091703,0.6791808873720137,0.7445652173913043,0.5195822454308094,0.6634382566585957,0.5887573964497042,368,383,199,184,94,274,0.62982689747004,0.6320737314110569,0.6320737314110569
19,1,40,0.633495145631068,0.6696165191740413,0.6997319034852547,0.6005291005291006,0.664968152866242,0.6331938633193863,373,378,227,151,112,261,0.6498002663115846,0.6501305020071775,0.6501305020071776
19,1,41,0.656641604010025,0.6392045454545454,0.6735218508997429,0.6215469613259669,0.6649746192893402,0.6302521008403361,389,362,225,137,127,262,0.6484687083888149,0.647534406112855,0.6475344061128548
19,1,42,0.6307339449541285,0.6698412698412698,0.7255936675461742,0.5672043010752689,0.6748466257668712,0.6142649199417759,379,372,211,161,104,275,0.6471371504660453,0.6463989843107215,0.6463989843107215
19,1,43,0.6103286384976526,0.6430769230769231,0.6914893617021277,0.5573333333333333,0.6483790523690773,0.5971428571428572,376,375,209,166,116,260,0.6245006657789614,0.6244113475177304,0.6244113475177304
19,1,44,0.6462264150943396,0.6819571865443425,0.7248677248677249,0.5978552278820375,0.6832917705735662,0.637142857142857,378,373,223,150,104,274,0.6617842876165113,0.6613614763748812,0.6613614763748812
19,1,45,0.60431654676259,0.6526946107784432,0.6847826086956522,0.5691906005221932,0.6420382165605096,0.608089260808926,368,383,218,165,116,252,0.625832223701731,0.6269866046089227,0.6269866046089226
19,1,46,0.6215596330275229,0.6888888888888889,0.7344173441734417,0.5680628272251309,0.6732919254658385,0.6226685796269728,369,382,217,165,98,271,0.6498002663115846,0.6512400856992864,0.6512400856992863
19,1,47,0.6342710997442456,0.6527777777777778,0.6648793565683646,0.6216931216931217,0.6492146596858639,0.6368563685636857,373,378,235,143,125,248,0.6431424766977364,0.643286239130743,0.6432862391307432
19,1,48,0.6381909547738693,0.660056657223796,0.679144385026738,0.6180371352785146,0.6580310880829016,0.6383561643835616,374,377,233,144,120,254,0.6484687083888149,0.6485907601526263,0.6485907601526263
19,1,49,0.6291390728476821,0.7013422818791947,0.7620320855614974,0.5543766578249337,0.6892382103990327,0.6192592592592593,374,377,209,168,89,285,0.6577896138482024,0.6582043716932156,0.6582043716932154
19,1,50,0.6294536817102138,0.6636363636363637,0.7047872340425532,0.584,0.6649937264742786,0.6212765957446809,376,375,219,156,111,265,0.644474034620506,0.6443936170212766,0.6443936170212766
19,1,51,0.6195652173913043,0.6701030927835051,0.7480314960629921,0.527027027027027,0.6777645659928656,0.5900151285930407,381,370,195,175,96,285,0.6391478029294274,0.6375292615450096,0.6375292615450096
19,1,52,0.6435406698564593,0.6876876876876877,0.7211796246648794,0.6058201058201058,0.6801517067003793,0.6441631504922644,373,378,229,149,104,269,0.6631158455392809,0.6634998652424926,0.6634998652424926
19,1,53,0.6363636363636364,0.6832298136645962,0.728,0.5851063829787234,0.6791044776119403,0.6303724928366763,375,376,220,156,102,273,0.6564580559254327,0.6565531914893618,0.6565531914893618
19,1,54,0.6383495145631068,0.6607669616519174,0.6957671957671958,0.6005361930294906,0.6658227848101266,0.6292134831460674,378,373,224,149,115,263,0.6484687083888149,0.6481516943983432,0.6481516943983432
19,1,55,0.6487804878048781,0.7038123167155426,0.7247956403269755,0.625,0.6846846846846848,0.6620689655172415,367,384,240,144,101,266,0.6737683089214381,0.6748978201634876,0.6748978201634878
19,1,56,0.6568627450980392,0.6618075801749271,0.6979166666666666,0.6185286103542235,0.6767676767676768,0.6394366197183099,384,367,227,140,116,268,0.6591211717709721,0.658222638510445,0.6582226385104452
19,1,57,0.6615776081424937,0.6620111731843575,0.6824146981627297,0.6405405405405405,0.6718346253229974,0.6510989010989011,381,370,237,133,121,260,0.6617842876165113,0.6614776193516352,0.6614776193516351
19,1,58,0.6401985111662531,0.6666666666666666,0.6898395721925134,0.6153846153846154,0.6640926640926641,0.64,374,377,232,145,116,258,0.6524633821571239,0.6526120937885644,0.6526120937885644
19,1,59,0.6382978723404256,0.6676829268292683,0.712401055408971,0.5887096774193549,0.6733167082294265,0.6257142857142858,379,372,219,153,109,270,0.6511318242343542,0.6505553664141629,0.650555366414163
19,1,60,0.654228855721393,0.6905444126074498,0.7088948787061995,0.6342105263157894,0.6804657179818888,0.6611796982167353,371,380,241,139,108,263,0.6711051930758988,0.6715527025109945,0.6715527025109945
19,1,61,0.6395061728395062,0.661849710982659,0.6888297872340425,0.6106666666666667,0.6632522407170295,0.6352288488210819,376,375,229,146,117,259,0.6498002663115846,0.6497482269503546,0.6497482269503546
19,1,62,0.6370370370370371,0.6820809248554913,0.7010869565217391,0.6161879895561357,0.6675291073738681,0.6474622770919067,368,383,236,147,110,258,0.6577896138482024,0.6586374730389375,0.6586374730389374
19,1,63,0.5976190476190476,0.649546827794562,0.6839237057220708,0.5598958333333334,0.6378653113087676,0.6013986013986016,367,384,215,169,116,251,0.6205059920106525,0.621909769527702,0.6219097695277022
19,1,64,0.6222707423580786,0.7098976109215017,0.7702702702702703,0.5459317585301837,0.6884057971014492,0.6172106824925816,370,381,208,173,85,285,0.6564580559254327,0.658101014400227,0.6581010144002271
19,1,65,0.6255707762557078,0.6741214057507987,0.7287234042553191,0.5626666666666666,0.6732186732186732,0.6133720930232558,376,375,211,164,102,274,0.6458055925432756,0.6456950354609928,0.6456950354609929
19,1,66,0.6395348837209303,0.6635514018691588,0.7180156657963447,0.5788043478260869,0.6765067650676506,0.6182873730043541,383,368,213,155,108,275,0.6498002663115846,0.6484100068112157,0.6484100068112157
19,1,67,0.6519607843137255,0.6588921282798834,0.6945169712793734,0.6141304347826086,0.672566371681416,0.6357243319268635,383,368,226,142,117,266,0.6551264980026631,0.654323703030991,0.654323703030991
19,1,68,0.6826196473551638,0.6949152542372882,0.7150395778364116,0.6612903225806451,0.6984536082474226,0.6776859504132231,379,372,246,126,108,271,0.6884154460719041,0.6881649502085285,0.6881649502085283
19,1,69,0.625,0.641399416909621,0.6746031746031746,0.5898123324396782,0.6488549618320612,0.6145251396648045,378,373,220,153,123,255,0.6324900133155792,0.6322077535214264,0.6322077535214264
19,1,70,0.6164383561643836,0.6549520766773163,0.7142857142857143,0.5495978552278821,0.661764705882353,0.597667638483965,378,373,205,168,108,270,0.6324900133155792,0.6319417847567982,0.6319417847567982
19,1,71,0.6342042755344418,0.6696969696969697,0.7101063829787234,0.5893333333333334,0.6700125470514429,0.6269503546099291,376,375,221,154,109,267,0.6498002663115846,0.6497198581560284,0.6497198581560284
19,1,72,0.6404761904761904,0.6586102719033232,0.7041884816753927,0.5907859078590786,0.6708229426433915,0.6228571428571429,382,369,218,151,113,269,0.6484687083888149,0.6474871947672357,0.6474871947672356
19,1,73,0.6155660377358491,0.6422018348623854,0.6904761904761905,0.5630026809651475,0.6508728179551122,0.6000000000000001,378,373,210,163,117,261,0.6271637816245007,0.6267394357206689,0.626739435720669
19,1,74,0.6766917293233082,0.6875,0.7105263157894737,0.6522911051212938,0.6931964056482671,0.6694329183955741,380,371,242,129,110,270,0.681757656458056,0.6814087104553838,0.6814087104553836
19,1,75,0.6155660377358491,0.6299694189602446,0.6832460732984293,0.5582655826558266,0.6476426799007444,0.5919540229885057,382,369,206,163,121,261,0.6218375499334221,0.6207558279771279,0.6207558279771279
19,1,76,0.6466346153846154,0.6805970149253732,0.7154255319148937,0.608,0.6792929292929294,0.6422535211267606,376,375,228,147,107,269,0.6617842876165113,0.6617127659574469,0.6617127659574469
19,1,77,0.6370192307692307,0.6597014925373135,0.6992084432717678,0.5940860215053764,0.6666666666666666,0.6251768033946253,379,372,221,151,114,265,0.6471371504660453,0.646647232388572,0.6466472323885721
19,1,78,0.6529126213592233,0.6814159292035398,0.713527851458886,0.6176470588235294,0.6818757921419518,0.6479663394109397,377,374,231,143,108,269,0.6657789613848203,0.6655874551412078,0.6655874551412077
19,1,79,0.6395348837209303,0.6728971962616822,0.7236842105263158,0.5822102425876011,0.6790123456790124,0.6242774566473989,380,371,216,155,105,275,0.6537949400798935,0.6529472265569585,0.6529472265569584
19,1,80,0.633177570093458,0.6904024767801857,0.7304582210242587,0.5868421052631579,0.6783479349186484,0.6344238975817923,371,380,223,157,100,271,0.6577896138482024,0.6586501631437083,0.6586501631437083
19,1,81,0.630071599045346,0.6566265060240963,0.6984126984126984,0.5844504021447721,0.6624843161856964,0.6184397163120567,378,373,218,155,114,264,0.6418109187749668,0.6414315502787352,0.6414315502787352
19,1,82,0.6126126126126126,0.6742671009771987,0.7311827956989247,0.5461741424802111,0.6666666666666666,0.6034985422740524,372,379,207,172,100,272,0.6378162450066578,0.6386784690895679,0.6386784690895679
19,1,83,0.6633165829145728,0.6827195467422096,0.7021276595744681,0.6426666666666667,0.6821705426356589,0.6620879120879121,376,375,241,134,112,264,0.6724367509986684,0.6723971631205674,0.6723971631205674
19,1,84,0.634703196347032,0.6964856230031949,0.7453083109919572,0.5767195767195767,0.68557336621455,0.6309696092619393,373,378,218,160,95,278,0.6604527296937417,0.661013943855767,0.661013943855767
19,1,85,0.6533665835411472,0.6514285714285715,0.6822916666666666,0.6212534059945504,0.667515923566879,0.6359832635983264,384,367,228,139,122,262,0.6524633821571239,0.6517725363306085,0.6517725363306085
19,1,86,0.6469194312796208,0.6778115501519757,0.7203166226912929,0.5994623655913979,0.6816479400749065,0.6362339514978601,379,372,223,149,106,273,0.6604527296937417,0.6598894941413453,0.6598894941413455
19,1,87,0.6370023419203747,0.6759259259259259,0.7214854111405835,0.5855614973262032,0.6766169154228856,0.6275071633237822,377,374,219,155,105,272,0.6537949400798935,0.6535234542333933,0.6535234542333933
19,1,88,0.6104218362282878,0.6551724137931034,0.6721311475409836,0.5922077922077922,0.6397919375812744,0.6221009549795361,366,385,228,157,120,246,0.6311584553928096,0.6321694698743879,0.6321694698743879
19,1,89,0.6536697247706422,0.6984126984126984,0.75,0.5929919137466307,0.6985294117647058,0.6413994169096211,380,371,220,151,95,285,0.6724367509986684,0.6714959568733154,0.6714959568733154
19,1,90,0.6303317535545023,0.6595744680851063,0.7037037037037037,0.5817694369973191,0.6649999999999999,0.6182336182336182,378,373,217,156,112,266,0.6431424766977364,0.6427365703505112,0.6427365703505115
19,1,91,0.6568627450980392,0.6588921282798834,0.6961038961038961,0.6174863387978142,0.6759142496847415,0.6375176304654443,385,366,226,140,117,268,0.6577896138482024,0.6567951174508552,0.6567951174508552
19,1,92,0.6483253588516746,0.6546546546546547,0.7020725388601037,0.5972602739726027,0.6741293532338308,0.6246418338108882,386,365,218,147,115,271,0.6511318242343542,0.6496664064163533,0.6496664064163533
19,1,93,0.6506024096385542,0.6726190476190477,0.7105263157894737,0.6091644204851752,0.679245283018868,0.6393210749646393,380,371,226,145,110,270,0.6604527296937417,0.6598453681373244,0.6598453681373244
19,1,94,0.6573426573426573,0.6956521739130435,0.7421052631578947,0.6037735849056604,0.6971569839307786,0.6464646464646465,380,371,224,147,98,282,0.6737683089214381,0.6729394240317775,0.6729394240317774
19,1,95,0.6365740740740741,0.6896551724137931,0.7352941176470589,0.583554376657825,0.6823821339950373,0.632183908045977,374,377,220,157,99,275,0.6591211717709721,0.6594242471524419,0.6594242471524419
19,1,96,0.6617647058823529,0.6909620991253644,0.7180851063829787,0.632,0.6887755102040817,0.6601671309192201,376,375,237,138,106,270,0.6750998668442078,0.6750425531914894,0.6750425531914894
19,1,97,0.627039627039627,0.6894409937888198,0.7289972899728997,0.581151832460733,0.6741854636591478,0.6306818181818181,369,382,222,160,100,269,0.6537949400798935,0.6550745612168163,0.6550745612168164
19,1,98,0.628428927680798,0.6485714285714286,0.672,0.6037234042553191,0.6494845360824743,0.62534435261708,375,376,227,149,123,252,0.6378162450066578,0.6378617021276597,0.6378617021276595
19,1,99,0.6428571428571429,0.7066246056782335,0.75,0.5910290237467019,0.6923076923076924,0.6436781609195403,372,379,224,155,93,279,0.6697736351531292,0.6705145118733509,0.670514511873351
3,0,0,0.4098360655737705,0.8684759916492694,0.2840909090909091,0.9203539823008849,0.33557046979865773,0.8936627282491945,352,1808,1664,144,252,100,0.8166666666666667,0.602222445695897,0.602222445695897
3,0,1,0.38362068965517243,0.8692946058091287,0.26099706744868034,0.9213853765805388,0.31064572425828973,0.8945823325326928,341,1819,1676,143,252,89,0.8171296296296297,0.5911912220146095,0.5911912220146096
3,0,2,0.39748953974895396,0.8667360749609578,0.2706552706552707,0.9203980099502488,0.3220338983050847,0.8927613941018767,351,1809,1665,144,256,95,0.8148148148148148,0.5955266403027598,0.5955266403027597
3,0,3,0.3900414937759336,0.8744137571651902,0.28059701492537314,0.9194520547945205,0.32638888888888895,0.8963675213675213,335,1825,1678,147,241,94,0.8203703703703704,0.6000245348599469,0.6000245348599469
3,0,4,0.4008097165991903,0.8755880815473079,0.29376854599406527,0.9188151398793198,0.339041095890411,0.8966809421841543,337,1823,1675,148,238,99,0.8212962962962963,0.6062918429366926,0.6062918429366926
3,0,5,0.4066390041493776,0.8744137571651902,0.2890855457227139,0.9214717188358045,0.33793103448275863,0.897326203208556,339,1821,1678,143,241,98,0.8222222222222222,0.6052786322792593,0.6052786322792592
3,0,6,0.4206008583690987,0.8718214841722886,0.28405797101449276,0.9256198347107438,0.3391003460207612,0.8979155531801176,345,1815,1680,135,247,98,0.8231481481481482,0.6048389028626183,0.6048389028626182
3,0,7,0.36637931034482757,0.870850622406639,0.25449101796407186,0.9194961664841182,0.3003533568904594,0.8945125199786894,334,1826,1679,147,249,85,0.8166666666666667,0.586993592224095,0.586993592224095
3,0,8,0.37872340425531914,0.8685714285714285,0.260233918128655,0.9196919691969196,0.30849220103986136,0.8934010152284263,342,1818,1672,146,253,89,0.8152777777777778,0.5899629436627873,0.5899629436627872
3,0,9,0.4104803493449782,0.8694976696012429,0.27167630057803466,0.9255788313120177,0.3269565217391304,0.8966622162883845,346,1814,1679,135,252,94,0.8208333333333333,0.5986275659450262,0.5986275659450262
3,0,10,0.39271255060728744,0.8719289074751699,0.28362573099415206,0.9174917491749175,0.3293718166383701,0.8941302599839185,342,1818,1668,150,245,97,0.8171296296296297,0.6005587400845348,0.6005587400845347
3,0,11,0.3709677419354839,0.875,0.27794561933534745,0.91470749043193,0.31778929188255617,0.8944132584870356,331,1829,1673,156,239,92,0.8171296296296297,0.5963265548836386,0.5963265548836387
3,0,12,0.3770491803278688,0.8742171189979123,0.27627627627627627,0.9168035030103996,0.31889081455805895,0.8950040074806305,333,1827,1675,152,241,92,0.8180555555555555,0.5965398896433379,0.5965398896433379
3,0,13,0.391304347826087,0.8704663212435233,0.2647058823529412,0.9230769230769231,0.3157894736842105,0.896,340,1820,1680,140,250,90,0.8194444444444444,0.5938914027149321,0.5938914027149321
3,0,14,0.39473684210526316,0.8742236024844721,0.2702702702702703,0.9244663382594417,0.32085561497326204,0.8986432561851555,333,1827,1689,138,243,90,0.8236111111111111,0.5973683042648559,0.597368304264856
3,0,15,0.38493723849372385,0.8651743883394065,0.2621082621082621,0.9187396351575456,0.311864406779661,0.8911528150134048,351,1809,1662,147,259,92,0.812037037037037,0.5904239486329039,0.5904239486329039
3,0,16,0.3876651982378855,0.8644593895499224,0.25142857142857145,0.9232044198895027,0.30502599653379553,0.8928666844776917,350,1810,1671,139,262,88,0.8143518518518519,0.587316495659037,0.5873164956590371
3,0,17,0.3717948717948718,0.8686396677050883,0.25588235294117645,0.9192307692307692,0.30313588850174217,0.8932194340630005,340,1820,1673,147,253,87,0.8148148148148148,0.5875565610859729,0.5875565610859728
3,0,18,0.3795918367346939,0.8673629242819844,0.2680115273775216,0.9161610590182019,0.3141891891891892,0.8910944206008583,347,1813,1661,152,254,93,0.812037037037037,0.5920862931978618,0.5920862931978618
3,0,19,0.398406374501992,0.8711367207962284,0.28901734104046245,0.9167585446527012,0.3350083752093802,0.8933655654042438,346,1814,1663,151,246,100,0.8162037037037037,0.6028879428465819,0.6028879428465819
3,0,20,0.3877551020408163,0.8741514360313316,0.28273809523809523,0.9177631578947368,0.32702237521514627,0.8954265846483016,336,1824,1674,150,241,95,0.8189814814814815,0.6002506265664161,0.600250626566416
3,0,21,0.41201716738197425,0.8723404255319149,0.2807017543859649,0.9246424642464246,0.3339130434782609,0.8977303070761015,342,1818,1681,137,246,96,0.8226851851851852,0.6026721093161946,0.6026721093161947
3,0,22,0.3925619834710744,0.8706986444212722,0.27696793002915454,0.9190974133186571,0.3247863247863248,0.8942436412315931,343,1817,1670,147,248,95,0.8171296296296297,0.5980326716739058,0.5980326716739058
3,0,23,0.4,0.8644155844155844,0.2647887323943662,0.9218836565096953,0.31864406779661014,0.8922252010723859,355,1805,1664,141,261,94,0.8138888888888889,0.5933361944520308,0.5933361944520308
3,0,24,0.3991228070175439,0.8731884057971014,0.2708333333333333,0.924890350877193,0.32269503546099293,0.8982960596379127,336,1824,1687,137,245,91,0.8231481481481482,0.597861842105263,0.5978618421052632
3,0,25,0.38222222222222224,0.8723514211886305,0.25825825825825827,0.9239189928845101,0.3082437275985664,0.8973950026581606,333,1827,1688,139,247,86,0.8212962962962963,0.5910886255713842,0.5910886255713842
3,0,26,0.4122448979591837,0.8715404699738903,0.2910662824207493,0.9205736348593492,0.3412162162162162,0.8953862660944205,347,1813,1669,144,246,101,0.8194444444444444,0.6058199586400492,0.6058199586400492
3,0,27,0.3738738738738739,0.8653250773993808,0.24127906976744187,0.9234581497797357,0.2932862190812721,0.8934469898774642,344,1816,1677,139,261,83,0.8148148148148148,0.5823686097735887,0.5823686097735887
3,0,28,0.40271493212669685,0.8612686952037133,0.24860335195530725,0.9267480577136515,0.307426597582038,0.892809409248864,358,1802,1670,132,269,89,0.8143518518518519,0.5876757048344794,0.5876757048344794
3,0,29,0.37344398340248963,0.8650338718082334,0.25787965616045844,0.9166206515737162,0.3050847457627119,0.8900804289544236,349,1811,1660,151,259,90,0.8101851851851852,0.5872501538670873,0.5872501538670873
3,0,30,0.38934426229508196,0.8731732776617954,0.28106508875739644,0.9182217343578485,0.3264604810996563,0.8951310861423221,338,1822,1673,149,243,95,0.8185185185185185,0.5996434115576225,0.5996434115576225
3,0,31,0.3922413793103448,0.8682572614107884,0.263768115942029,0.9223140495867769,0.315424610051993,0.8944696767298957,345,1815,1674,141,254,91,0.8171296296296297,0.593041082764403,0.5930410827644029
3,0,32,0.4057377049180328,0.8710855949895616,0.2861271676300578,0.9200661521499449,0.33559322033898303,0.8949061662198392,346,1814,1669,145,247,99,0.8185185185185185,0.6030966598900014,0.6030966598900014
3,0,33,0.3803418803418803,0.8722741433021807,0.2656716417910448,0.9205479452054794,0.3128295254833041,0.895761130365236,335,1825,1680,145,246,89,0.8189814814814815,0.5931097934982621,0.5931097934982621
3,0,34,0.37551020408163266,0.8699738903394256,0.2697947214076246,0.9158878504672897,0.31399317406143346,0.8923406534547402,341,1819,1666,153,249,92,0.8138888888888889,0.5928412859374571,0.5928412859374572
3,0,35,0.40425531914893614,0.8696103896103896,0.2745664739884393,0.9228224917309813,0.32702237521514627,0.8954265846483017,346,1814,1674,140,251,95,0.8189814814814815,0.5986944828597103,0.5986944828597103
3,0,36,0.397196261682243,0.8648509763617678,0.2442528735632184,0.9288079470198676,0.30249110320284694,0.8956891963810538,348,1812,1683,129,263,85,0.8185185185185185,0.586530410291543,0.586530410291543
3,0,37,0.40585774058577406,0.8709005726184279,0.2811594202898551,0.9217630853994491,0.3321917808219178,0.895610278372591,345,1815,1673,142,248,97,0.8194444444444444,0.6014612528446521,0.6014612528446521
3,0,38,0.41409691629955947,0.8696326952922918,0.27167630057803466,0.9266813671444322,0.3280977312390925,0.8972511342407259,346,1814,1681,133,252,94,0.8217592592592593,0.5991788338612335,0.5991788338612334
3,0,39,0.41228070175438597,0.8685300207039337,0.27011494252873564,0.9260485651214128,0.3263888888888889,0.8963675213675213,348,1812,1678,134,254,94,0.8203703703703704,0.5980817538250742,0.5980817538250742
3,0,40,0.3654618473895582,0.869701726844584,0.2676470588235294,0.9131868131868132,0.3089983022071307,0.8909139640846958,340,1820,1662,158,249,91,0.8115740740740741,0.5904169360051712,0.5904169360051712
3,0,41,0.36936936936936937,0.8648090815273478,0.23837209302325582,0.9229074889867841,0.28975265017667845,0.8929142248268512,344,1816,1676,140,262,82,0.8138888888888889,0.58063979100502,0.58063979100502
3,0,42,0.42105263157894735,0.8669772256728778,0.2719546742209632,0.926950747094632,0.3304647160068847,0.8959614870286173,353,1807,1675,132,257,96,0.8199074074074074,0.5994527106577975,0.5994527106577976
3,0,43,0.384297520661157,0.8686131386861314,0.26956521739130435,0.9179063360881543,0.31686541737649065,0.8925796946155907,345,1815,1666,149,252,93,0.8143518518518519,0.5937357767397293,0.5937357767397293
3,0,44,0.39148936170212767,0.8701298701298701,0.26900584795321636,0.9213421342134214,0.3188908145580589,0.8950040074806305,342,1818,1675,143,250,92,0.8180555555555555,0.5951739910833189,0.5951739910833189
3,0,45,0.3739495798319328,0.8673257023933403,0.25872093023255816,0.9179515418502202,0.30584192439862545,0.8919208132691279,344,1816,1667,149,255,89,0.812962962962963,0.5883362360413892,0.5883362360413892
3,0,46,0.3948497854077253,0.8671510119356513,0.26436781609195403,0.9221854304635762,0.31669535283993117,0.8938218775073549,348,1812,1671,141,256,92,0.8162037037037037,0.5932766232777651,0.5932766232777651
3,0,47,0.3891213389121339,0.8615304528891202,0.2590529247910863,0.9189339255968906,0.3110367892976589,0.8893068242880172,359,1801,1655,146,266,93,0.8092592592592592,0.5889934251939886,0.5889934251939885
3,0,48,0.3799126637554585,0.8674262040393579,0.2536443148688047,0.9218492019812878,0.3041958041958042,0.8938100320170758,343,1817,1675,142,256,87,0.8157407407407408,0.5877467584250463,0.5877467584250463
3,0,49,0.4050632911392405,0.8725949037961519,0.28152492668621704,0.9224848818031886,0.3321799307958478,0.8968466060929984,341,1819,1678,141,245,96,0.8212962962962963,0.6020049042447028,0.6020049042447028
3,0,50,0.39819004524886875,0.8684889118102115,0.2565597667638484,0.9268024215740231,0.3120567375886525,0.8966986155484559,343,1817,1684,133,255,88,0.8203703703703704,0.5916810941689358,0.5916810941689358
3,0,51,0.4008438818565401,0.8705148205928237,0.2761627906976744,0.9218061674008811,0.32702237521514627,0.8954265846483017,344,1816,1674,142,249,95,0.8189814814814815,0.5989844790492778,0.5989844790492778
3,0,52,0.3939393939393939,0.8683255572835666,0.263768115942029,0.9228650137741047,0.3159722222222222,0.8947649572649574,345,1815,1675,140,254,91,0.8175925925925925,0.5933165648580669,0.5933165648580669
3,0,53,0.4041666666666667,0.871875,0.282798833819242,0.9212988442487617,0.33276157804459694,0.8959058067968959,343,1817,1674,143,246,97,0.8199074074074074,0.6020488390340019,0.6020488390340019
3,0,54,0.4125,0.8744791666666667,0.2911764705882353,0.9225274725274726,0.34137931034482766,0.8978609625668449,340,1820,1679,141,241,99,0.8231481481481482,0.606851971557854,0.606851971557854
3,0,55,0.38961038961038963,0.8688439606013478,0.26239067055393583,0.9223995597138139,0.313588850174216,0.8948211425520555,343,1817,1676,141,253,90,0.8175925925925925,0.5923951151338749,0.5923951151338749
3,0,56,0.3865546218487395,0.8699271592091571,0.26900584795321636,0.9196919691969196,0.3172413793103448,0.8941176470588235,342,1818,1672,146,250,92,0.8166666666666667,0.5943489085750681,0.594348908575068
3,0,57,0.36554621848739494,0.8678459937565036,0.25513196480938416,0.9169873556899395,0.30051813471502586,0.8917401764234162,341,1819,1668,151,254,87,0.8125,0.5860596602496618,0.5860596602496618
3,0,58,0.37339055793991416,0.8676699532952776,0.2543859649122807,0.9196919691969196,0.3026086956521739,0.8929238985313751,342,1818,1672,146,255,87,0.8143518518518519,0.5870389670546002,0.5870389670546001
3,0,59,0.37448559670781895,0.8685446009389671,0.2653061224489796,0.9163456246560264,0.310580204778157,0.8918050348152116,343,1817,1665,152,252,91,0.812962962962963,0.590825873552503,0.5908258735525029
3,0,60,0.3805668016194332,0.8714061683220073,0.27647058823529413,0.9159340659340659,0.3202725724020443,0.8931154567372087,340,1820,1667,153,246,94,0.8152777777777778,0.59620232708468,0.5962023270846799
3,0,61,0.3826086956521739,0.8715025906735752,0.2619047619047619,0.9221491228070176,0.3109540636042403,0.8961108151305274,336,1824,1682,142,248,88,0.8194444444444444,0.5920269423558897,0.5920269423558897
3,0,62,0.36401673640167365,0.8703800104112441,0.25892857142857145,0.9166666666666666,0.3026086956521739,0.8929238985313751,336,1824,1672,152,249,87,0.8143518518518519,0.587797619047619,0.587797619047619
3,0,63,0.37815126050420167,0.8740894901144641,0.2710843373493976,0.9190371991247265,0.31578947368421045,0.896,332,1828,1680,148,242,90,0.8194444444444444,0.595060768237062,0.5950607682370621
3,0,64,0.3795918367346939,0.8710182767624021,0.2735294117647059,0.9164835164835164,0.317948717948718,0.8931726907630522,340,1820,1668,152,247,93,0.8152777777777778,0.5950064641241112,0.5950064641241112
3,0,65,0.38461538461538464,0.8717549325025961,0.26706231454005935,0.9210093252879868,0.31523642732049034,0.8957055214723927,337,1823,1679,144,247,90,0.8189814814814815,0.5940358199140231,0.5940358199140231
3,0,66,0.40358744394618834,0.8709344346928239,0.2647058823529412,0.926923076923077,0.3197158081705151,0.8980569603406974,340,1820,1687,133,250,90,0.8226851851851852,0.595814479638009,0.595814479638009
3,0,67,0.37554585152838427,0.8710512687726567,0.25671641791044775,0.9216438356164384,0.3049645390070922,0.8956336528221512,335,1825,1682,143,249,86,0.8185185185185185,0.5891801267634431,0.589180126763443
3,0,68,0.40789473684210525,0.8674948240165632,0.2664756446991404,0.9254555494202098,0.3223570190641248,0.8955383382313653,349,1811,1676,135,256,93,0.8189814814814815,0.5959655970596752,0.5959655970596751
3,0,69,0.4,0.865974025974026,0.26704545454545453,0.9220132743362832,0.3202725724020443,0.8931154567372086,352,1808,1667,141,258,94,0.8152777777777778,0.5945293644408689,0.5945293644408689
3,0,70,0.40425531914893614,0.8727272727272727,0.27941176470588236,0.9230769230769231,0.3304347826086957,0.897196261682243,340,1820,1680,140,245,95,0.8217592592592593,0.6012443438914027,0.6012443438914028
3,0,71,0.3780487804878049,0.8699059561128527,0.2719298245614035,0.9158415841584159,0.31632653061224486,0.8922829581993569,342,1818,1665,153,249,93,0.8138888888888889,0.5938857043599096,0.5938857043599097
3,0,72,0.3829787234042553,0.8706493506493507,0.26548672566371684,0.9203734211971444,0.313588850174216,0.8948211425520556,339,1821,1676,145,249,90,0.8175925925925925,0.5929300734304306,0.5929300734304306
3,0,73,0.3868312757201646,0.8680229525299947,0.27089337175792505,0.9178157749586321,0.3186440677966102,0.8922252010723861,347,1813,1664,149,253,94,0.8138888888888889,0.5943545733582786,0.5943545733582786
3,0,74,0.3565217391304348,0.8652849740932642,0.23976608187134502,0.9185918591859186,0.2867132867132867,0.8911419423692636,342,1818,1670,148,260,82,0.8111111111111111,0.5791789705286318,0.5791789705286319
3,0,75,0.3991228070175439,0.8669772256728778,0.2614942528735632,0.92439293598234,0.3159722222222222,0.8947649572649573,348,1812,1675,137,257,91,0.8175925925925925,0.5929435944279516,0.5929435944279515
3,0,76,0.3684210526315789,0.8698379508625196,0.2676470588235294,0.9142857142857143,0.31005110732538327,0.8915081703723546,340,1820,1664,156,249,91,0.8125,0.5909663865546219,0.5909663865546219
3,0,77,0.3941908713692946,0.8718082334549244,0.2785923753665689,0.919736118746564,0.32646048109965636,0.8951310861423222,341,1819,1673,146,246,95,0.8185185185185185,0.5991642470565663,0.5991642470565665
3,0,78,0.3879310344827586,0.8625518672199171,0.2535211267605634,0.9213296398891967,0.30664395229982966,0.8909724082507366,355,1805,1663,142,265,90,0.8115740740740741,0.58742538332488,0.58742538332488
3,0,79,0.40086206896551724,0.8677385892116183,0.2672413793103448,0.923289183222958,0.3206896551724137,0.8946524064171122,348,1812,1673,139,255,93,0.8175925925925925,0.5952652812666515,0.5952652812666515
3,0,80,0.41150442477876104,0.8671147880041365,0.26571428571428574,0.9265193370165746,0.3229166666666667,0.8958333333333335,350,1810,1677,133,257,93,0.8194444444444444,0.5961168113654303,0.5961168113654302
3,0,81,0.37333333333333335,0.8640826873385012,0.2420749279538905,0.9222283507997794,0.2937062937062937,0.8922091782283885,347,1813,1672,141,263,84,0.812962962962963,0.5821516393768349,0.5821516393768349
3,0,82,0.36818181818181817,0.8644329896907217,0.23546511627906977,0.9234581497797357,0.2872340425531915,0.8929712460063898,344,1816,1677,139,263,81,0.8138888888888889,0.5794616330294027,0.5794616330294028
3,0,83,0.4185022026431718,0.868080703569581,0.2714285714285714,0.9270718232044199,0.3292894280762565,0.8966069997328348,350,1810,1678,132,255,95,0.8208333333333333,0.5992501973164956,0.5992501973164956
3,0,84,0.3964757709251101,0.8639420589756854,0.254957507082153,0.9241837299391257,0.3103448275862069,0.8930481283422459,353,1807,1670,137,263,90,0.8148148148148148,0.5895706185106392,0.5895706185106393
3,0,85,0.3940677966101695,0.867983367983368,0.2680115273775216,0.9211252068394925,0.31903945111492277,0.8937650521808936,347,1813,1670,143,254,93,0.8162037037037037,0.594568367108507,0.5945683671085071
3,0,86,0.4100418410041841,0.8709005726184279,0.2832369942196532,0.922271223814774,0.3350427350427351,0.8958500669344043,346,1814,1673,141,248,98,0.8199074074074074,0.6027541090172137,0.6027541090172136
3,0,87,0.4177215189873418,0.875715028601144,0.29289940828402367,0.9242590559824369,0.3443478260869565,0.8993324432576769,338,1822,1684,138,239,99,0.825462962962963,0.6085792321332303,0.6085792321332303
3,0,88,0.37719298245614036,0.8685300207039337,0.2529411764705882,0.921978021978022,0.3028169014084507,0.8944562899786781,340,1820,1678,142,254,86,0.8166666666666667,0.5874595992243052,0.5874595992243051
3,0,89,0.39655172413793105,0.8656639004149378,0.2621082621082621,0.9226091763405196,0.3156089193825043,0.8932298635268933,351,1809,1669,140,259,92,0.8152777777777778,0.592358719224391,0.5923587192243909
3,0,90,0.3699186991869919,0.8746081504702194,0.27492447129909364,0.9152542372881356,0.31542461005199307,0.8944696767298957,331,1829,1674,155,240,91,0.8171296296296297,0.5950893542936146,0.5950893542936146
3,0,91,0.3991228070175439,0.8726708074534162,0.27002967359050445,0.9248491497531541,0.32212389380530976,0.8980026631158455,337,1823,1686,137,246,91,0.8226851851851852,0.5974394116718292,0.5974394116718293
3,0,92,0.3836734693877551,0.8710182767624021,0.2756598240469208,0.9169873556899395,0.32081911262798635,0.8934118907337975,341,1819,1668,151,247,94,0.8157407407407408,0.5963235898684301,0.5963235898684301
3,0,93,0.42735042735042733,0.8691588785046729,0.2840909090909091,0.9258849557522124,0.3412969283276451,0.8966256025709695,352,1808,1674,134,252,100,0.8212962962962963,0.6049879324215608,0.6049879324215608
3,0,94,0.40444444444444444,0.8723514211886305,0.2692307692307692,0.9264544456641054,0.32326820603907636,0.898589299973383,338,1822,1688,134,247,91,0.8236111111111111,0.5978426074474373,0.5978426074474373
3,0,95,0.4008438818565401,0.8705148205928237,0.2761627906976744,0.9218061674008811,0.32702237521514627,0.8954265846483017,344,1816,1674,142,249,95,0.8189814814814815,0.5989844790492778,0.5989844790492778
3,0,96,0.3697478991596639,0.872528616024974,0.26426426426426425,0.9178981937602627,0.308231173380035,0.8946385702854094,333,1827,1677,150,245,88,0.8171296296296297,0.5910812290122635,0.5910812290122636
3,0,97,0.3755274261603376,0.8725949037961519,0.26646706586826346,0.91894852135816,0.3117338003502627,0.8951720458789011,334,1826,1678,148,245,89,0.8180555555555555,0.5927077936132117,0.5927077936132117
3,0,98,0.40562248995983935,0.8717948717948718,0.29190751445086704,0.918412348401323,0.3394957983193277,0.8944966442953021,346,1814,1666,148,245,101,0.8180555555555555,0.605159931426095,0.605159931426095
3,0,99,0.39915966386554624,0.8704474505723205,0.2761627906976744,0.9212555066079295,0.32646048109965636,0.8951310861423222,344,1816,1673,143,249,95,0.8185185185185185,0.598709148652802,0.598709148652802
5,0,0,0.5085714285714286,0.8695214105793451,0.2557471264367816,0.9525386313465783,0.34034416826003827,0.9091387937845667,348,1812,1726,86,259,89,0.8402777777777778,0.60414287889168,0.60414287889168
5,0,1,0.46511627906976744,0.869215291750503,0.23529411764705882,0.9494505494505494,0.3125,0.907563025210084,340,1820,1728,92,260,80,0.837037037037037,0.5923723335488041,0.5923723335488041
5,0,2,0.4860335195530726,0.8712771327612318,0.2543859649122807,0.9493949394939494,0.33397312859884837,0.908660173729929,342,1818,1726,92,255,87,0.8393518518518519,0.6018904522031151,0.601890452203115
5,0,3,0.47752808988764045,0.8683148335015136,0.24566473988439305,0.9487320837927232,0.3244274809160305,0.9067439409905164,346,1814,1721,93,261,85,0.8361111111111111,0.5971984118385582,0.5971984118385582
5,0,4,0.5176470588235295,0.871859296482412,0.2565597667638484,0.9548706659328564,0.3430799220272905,0.911478854741266,343,1817,1735,82,255,88,0.8439814814814814,0.6057152163483523,0.6057152163483525
5,0,5,0.4578313253012048,0.8650952858575727,0.22028985507246376,0.9504132231404959,0.2974559686888454,0.9057495405618273,345,1815,1725,90,269,76,0.8337962962962963,0.5853515391064797,0.5853515391064799
5,0,6,0.4647058823529412,0.871859296482412,0.23652694610778444,0.9501642935377875,0.3134920634920635,0.9093291404612159,334,1826,1735,91,255,79,0.8398148148148148,0.5933456198227859,0.593345619822786
5,0,7,0.4913294797687861,0.8671363865123302,0.24355300859598855,0.951408061844285,0.3256704980842912,0.9073196419167983,349,1811,1723,88,264,85,0.837037037037037,0.5974805352201367,0.5974805352201368
5,0,8,0.5202312138728323,0.8671363865123302,0.2542372881355932,0.9540420819490587,0.3415559772296015,0.9085156867914579,354,1806,1723,83,264,90,0.8393518518518519,0.604139685042326,0.604139685042326
5,0,9,0.47282608695652173,0.8724696356275303,0.25663716814159293,0.9467325645249862,0.33269598470363293,0.9080853305240979,339,1821,1724,97,252,87,0.8384259259259259,0.6016848663332895,0.6016848663332895
5,0,10,0.5082872928176796,0.8721576553815058,0.26666666666666666,0.9509641873278237,0.349809885931559,0.9098576700052716,345,1815,1726,89,253,92,0.8416666666666667,0.6088154269972452,0.6088154269972452
5,0,11,0.5146198830409356,0.869281045751634,0.25287356321839083,0.9541942604856513,0.33911368015414256,0.9097605893186004,348,1812,1729,83,260,88,0.8412037037037037,0.603533911852021,0.603533911852021
5,0,12,0.4885057471264368,0.8726082578046325,0.2514792899408284,0.9511525795828759,0.33203125000000006,0.9101890756302521,338,1822,1733,89,253,85,0.8416666666666667,0.6013159347618522,0.6013159347618521
5,0,13,0.49700598802395207,0.8660311088810838,0.23714285714285716,0.9535911602209944,0.32108317214700194,0.9077044438601104,350,1810,1726,84,267,83,0.8375,0.5953670086819258,0.5953670086819258
5,0,14,0.4644808743169399,0.8715225088517956,0.25073746312684364,0.9461834157056562,0.3256704980842912,0.9073196419167983,339,1821,1723,98,254,85,0.837037037037037,0.5984604394162498,0.5984604394162499
5,0,15,0.5029940119760479,0.8685398896136478,0.24277456647398843,0.954244762954796,0.32748538011695905,0.9093774625689519,346,1814,1731,83,262,84,0.8402777777777778,0.5985096647143922,0.5985096647143922
5,0,16,0.4911242603550296,0.8679055750878956,0.2398843930635838,0.9525909592061742,0.32233009708737864,0.9082785808147175,346,1814,1728,86,263,83,0.8384259259259259,0.596237676134879,0.596237676134879
5,0,17,0.4880952380952381,0.8689759036144579,0.239067055393586,0.9526692350027518,0.32093933463796476,0.9088999737463901,343,1817,1731,86,261,82,0.8393518518518519,0.5958681451981689,0.5958681451981689
5,0,18,0.5087719298245614,0.8677727501256913,0.24857142857142858,0.9535911602209944,0.33397312859884837,0.9086601737299289,350,1810,1726,84,263,87,0.8393518518518519,0.6010812943962116,0.6010812943962115
5,0,19,0.5089820359281437,0.8670346211741093,0.24285714285714285,0.9546961325966851,0.32882011605415856,0.9087562450696819,350,1810,1728,82,265,85,0.8393518518518519,0.5987766377269139,0.5987766377269139
5,0,20,0.5,0.8698492462311558,0.24709302325581395,0.9531938325991189,0.33073929961089493,0.9096163951655282,344,1816,1731,85,259,85,0.8407407407407408,0.6001434279274664,0.6001434279274664
5,0,21,0.47058823529411764,0.8753768844221106,0.24390243902439024,0.9508733624454149,0.321285140562249,0.9115646258503403,328,1832,1742,90,248,80,0.8435185185185186,0.5973879007349026,0.5973879007349026
5,0,22,0.45930232558139533,0.8697183098591549,0.23372781065088757,0.9489571899012075,0.30980392156862746,0.9076115485564304,338,1822,1729,93,259,79,0.837037037037037,0.5913425002760475,0.5913425002760475
5,0,23,0.4971751412429379,0.8643469490670701,0.24649859943977592,0.9506378258458126,0.3295880149812734,0.9054410987849973,357,1803,1714,89,269,88,0.8342592592592593,0.5985682126427943,0.5985682126427943
5,0,24,0.5057471264367817,0.8690835850956697,0.25287356321839083,0.9525386313465783,0.3371647509578544,0.9088994207477619,348,1812,1726,86,260,88,0.8398148148148148,0.6027060972824845,0.6027060972824846
5,0,25,0.4473684210526316,0.8710659898477158,0.25073746312684364,0.942339373970346,0.32136105860113423,0.9053020311263519,339,1821,1716,105,254,85,0.8337962962962963,0.5965384185485948,0.5965384185485948
5,0,26,0.4823529411764706,0.8658291457286432,0.2349570200573066,0.951408061844285,0.3159922928709056,0.9066035253880558,349,1811,1723,88,267,82,0.8356481481481481,0.5931825409507958,0.5931825409507958
5,0,27,0.48214285714285715,0.8699799196787149,0.23823529411764705,0.9521978021978021,0.3188976377952756,0.909233997901364,340,1820,1733,87,259,81,0.8398148148148148,0.5952165481577246,0.5952165481577246
5,0,28,0.49079754601226994,0.8652979469203805,0.22922636103151864,0.9541689674213142,0.3125,0.9075630252100841,349,1811,1728,83,269,80,0.837037037037037,0.5916976642264165,0.5916976642264165
5,0,29,0.4692737430167598,0.8677435638566381,0.24277456647398843,0.9476295479603087,0.32,0.9059288537549407,346,1814,1719,95,262,84,0.8347222222222223,0.5952020572171486,0.5952020572171486
5,0,30,0.45789473684210524,0.868020304568528,0.2507204610951009,0.9431880860452289,0.3240223463687151,0.9040444091990483,347,1813,1710,103,260,87,0.8319444444444445,0.5969542735701648,0.5969542735701648
5,0,31,0.5217391304347826,0.8714357178589295,0.24633431085043989,0.9576690489279824,0.33466135458167334,0.9125196437925617,341,1819,1742,77,257,84,0.8453703703703703,0.6020016798892112,0.6020016798892112
5,0,32,0.47619047619047616,0.8689759036144579,0.23460410557184752,0.9516217702034084,0.3143418467583497,0.9084229860928891,341,1819,1731,88,261,80,0.8384259259259259,0.593112937887628,0.593112937887628
5,0,33,0.5061728395061729,0.8678678678678678,0.23699421965317918,0.9558985667034179,0.3228346456692914,0.9097586568730326,346,1814,1734,80,264,82,0.8407407407407408,0.5964463931782985,0.5964463931782986
5,0,34,0.5,0.8661971830985915,0.24431818181818182,0.952433628318584,0.3282442748091603,0.9072708113804004,352,1808,1722,86,266,86,0.837037037037037,0.598375905068383,0.5983759050683829
5,0,35,0.5055555555555555,0.8676767676767677,0.2577903682719547,0.9507470946319867,0.34146341463414637,0.9073144969632956,353,1807,1718,89,262,91,0.8375,0.6042687314519707,0.6042687314519707
5,0,36,0.4588235294117647,0.8698492462311558,0.2314540059347181,0.9495337356006582,0.3076923076923077,0.9079464988198269,337,1823,1731,92,259,78,0.8375,0.5904938707676881,0.5904938707676882
5,0,37,0.5117647058823529,0.871356783919598,0.2536443148688047,0.9543203082003302,0.33918128654970764,0.9109535066981875,343,1817,1734,83,256,87,0.8430555555555556,0.6039823115345675,0.6039823115345675
5,0,38,0.48484848484848486,0.8636591478696742,0.22727272727272727,0.9529867256637168,0.3094777562862669,0.9061267420457534,352,1808,1723,85,272,80,0.8347222222222223,0.590129726468222,0.590129726468222
5,0,39,0.5094339622641509,0.8685657171414293,0.23546511627906977,0.9570484581497798,0.3220675944333996,0.9106628242074929,344,1816,1738,78,263,81,0.8421296296296297,0.5962567872144248,0.5962567872144248
5,0,40,0.4715909090909091,0.8679435483870968,0.24057971014492754,0.9487603305785124,0.31861804222648754,0.9065543564095814,345,1815,1722,93,262,83,0.8356481481481481,0.59467002036172,0.5946700203617199
5,0,41,0.4602272727272727,0.8714717741935484,0.24107142857142858,0.9479166666666666,0.31640625,0.9080882352941176,336,1824,1729,95,255,81,0.8379629629629629,0.5944940476190477,0.5944940476190477
5,0,42,0.4759036144578313,0.8665997993981945,0.2289855072463768,0.9520661157024793,0.30919765166340507,0.9073247571541087,345,1815,1728,87,266,79,0.836574074074074,0.5905258114744282,0.5905258114744281
5,0,43,0.4727272727272727,0.8701754385964913,0.2314540059347181,0.9522764673614921,0.31075697211155384,0.9093766369827134,337,1823,1736,87,259,78,0.8398148148148148,0.5918652366481051,0.5918652366481051
5,0,44,0.5060240963855421,0.8640922768304915,0.23661971830985915,0.9545706371191136,0.3224568138195777,0.9070808107396684,355,1805,1723,82,271,84,0.836574074074074,0.5955951777144864,0.5955951777144863
5,0,45,0.4601226993865031,0.871306960440661,0.22590361445783133,0.9518599562363238,0.30303030303030304,0.9098039215686274,332,1828,1740,88,257,75,0.8402777777777778,0.5888817853470775,0.5888817853470776
5,0,46,0.47058823529411764,0.8683417085427135,0.23391812865497075,0.9504950495049505,0.31249999999999994,0.907563025210084,342,1818,1728,90,262,80,0.837037037037037,0.5922065890799606,0.5922065890799606
5,0,47,0.49404761904761907,0.8684738955823293,0.24057971014492754,0.953168044077135,0.32358674463937626,0.9088521145258733,345,1815,1730,85,262,83,0.8393518518518519,0.5968738771110312,0.5968738771110312
5,0,48,0.5081967213114754,0.8735457764289327,0.27113702623906705,0.9504678040726472,0.35361216730038025,0.9103848181338955,343,1817,1727,90,250,93,0.8425925925925926,0.6108024151558571,0.6108024151558571
5,0,49,0.46551724137931033,0.8705941591137966,0.23964497041420119,0.9489571899012075,0.31640625000000006,0.9080882352941175,338,1822,1729,93,257,81,0.8379629629629629,0.5943010801577043,0.5943010801577043
5,0,50,0.47058823529411764,0.8698492462311558,0.2359882005899705,0.9505766062602965,0.3143418467583497,0.9084229860928891,339,1821,1731,90,259,80,0.8384259259259259,0.5932824034251335,0.5932824034251335
5,0,51,0.4723926380368098,0.8642964446670005,0.22126436781609196,0.9525386313465783,0.3013698630136986,0.9062746127592544,348,1812,1726,86,271,77,0.8347222222222223,0.5869014995813352,0.5869014995813351
5,0,52,0.47398843930635837,0.8686462003019627,0.239067055393586,0.9499174463401211,0.3178294573643411,0.907465825446898,343,1817,1726,91,261,82,0.837037037037037,0.5944922508668535,0.5944922508668535
5,0,53,0.49404761904761907,0.8679718875502008,0.2398843930635838,0.9531422271223815,0.3229571984435798,0.9085654230162902,346,1814,1729,85,263,83,0.8388888888888889,0.5965133100929827,0.5965133100929826
5,0,54,0.48863636363636365,0.8744959677419355,0.25671641791044775,0.9506849315068493,0.33659491193737767,0.9110002625360988,335,1825,1735,90,249,86,0.8430555555555556,0.6037006747086485,0.6037006747086485
5,0,55,0.5352941176470588,0.8673366834170855,0.2563380281690141,0.9562326869806094,0.3466666666666667,0.9096179183135706,355,1805,1726,79,264,91,0.8412037037037037,0.6062853575748117,0.6062853575748117
5,0,56,0.5142857142857142,0.871536523929471,0.2608695652173913,0.953168044077135,0.34615384615384615,0.9105263157894736,345,1815,1730,85,255,90,0.8425925925925926,0.6070188046472631,0.6070188046472632
5,0,57,0.49404761904761907,0.8729919678714859,0.24702380952380953,0.9533991228070176,0.32936507936507936,0.9114255765199161,336,1824,1739,85,253,83,0.8435185185185186,0.6002114661654135,0.6002114661654135
5,0,58,0.4823529411764706,0.8678391959798994,0.23768115942028986,0.9515151515151515,0.31844660194174756,0.9077529566360051,345,1815,1727,88,263,82,0.8375,0.5945981554677207,0.5945981554677207
5,0,59,0.5144508670520231,0.8721690991444389,0.2594752186588921,0.9537699504678041,0.3449612403100775,0.9111461619348055,343,1817,1733,84,254,89,0.8435185185185186,0.606622584563348,0.6066225845633482
5,0,60,0.48484848484848486,0.8681704260651629,0.23323615160349853,0.9532195927352779,0.31496062992125984,0.9087093389296956,343,1817,1732,85,263,80,0.8388888888888889,0.5932278721693881,0.5932278721693882
5,0,61,0.5260115606936416,0.8686462003019627,0.2585227272727273,0.9546460176991151,0.3466666666666667,0.9096179183135705,352,1808,1726,82,261,91,0.8412037037037037,0.6065843724859212,0.6065843724859212
5,0,62,0.46774193548387094,0.867274569402229,0.2492836676217765,0.9453340695748206,0.32523364485981304,0.9046235138705417,349,1811,1712,99,262,87,0.8328703703703704,0.5973088685982986,0.5973088685982985
5,0,63,0.4438202247191011,0.8728557013118062,0.23867069486404835,0.9458720612356479,0.3104125736738703,0.9078981894515875,331,1829,1730,99,252,79,0.8375,0.5922713780498482,0.5922713780498482
5,0,64,0.48863636363636365,0.8719758064516129,0.2529411764705882,0.9505494505494505,0.3333333333333333,0.9095688748685594,340,1820,1730,90,254,86,0.8407407407407408,0.6017453135100194,0.6017453135100194
5,0,65,0.5375722543352601,0.8706592853548062,0.26571428571428574,0.9558011049723757,0.35564053537284895,0.9112457203055043,350,1810,1730,80,257,93,0.8439814814814814,0.6107576953433308,0.6107576953433307
5,0,66,0.4883720930232558,0.8667002012072434,0.24068767908309455,0.951408061844285,0.32245681381957775,0.9070808107396684,349,1811,1723,88,265,84,0.836574074074074,0.5960478704636898,0.5960478704636898
5,0,67,0.480225988700565,0.8688855269793243,0.2463768115942029,0.9493112947658402,0.3256704980842912,0.9073196419167984,345,1815,1723,92,260,85,0.837037037037037,0.5978440531800215,0.5978440531800215
5,0,68,0.49101796407185627,0.870546914199699,0.2411764705882353,0.9532967032967034,0.3234714003944773,0.9100445843168109,340,1820,1735,85,258,82,0.8412037037037037,0.5972365869424693,0.5972365869424694
5,0,69,0.49142857142857144,0.8664987405541562,0.245014245014245,0.9508015478164732,0.32699619771863114,0.9066947812335265,351,1809,1720,89,265,86,0.8361111111111111,0.5979078964153591,0.5979078964153591
5,0,70,0.4722222222222222,0.8707070707070707,0.24926686217008798,0.9477735019241341,0.32629558541266795,0.9076072650697551,341,1819,1724,95,256,85,0.8375,0.5985201820471111,0.598520182047111
5,0,71,0.4857142857142857,0.8705289672544081,0.24853801169590642,0.9504950495049505,0.32882011605415856,0.9087562450696818,342,1818,1728,90,257,85,0.8393518518518519,0.5995165306004284,0.5995165306004284
5,0,72,0.5094339622641509,0.8650674662668666,0.23076923076923078,0.956882255389718,0.31764705882352945,0.9086614173228346,351,1809,1731,78,270,81,0.8388888888888889,0.5938257430794744,0.5938257430794743
5,0,73,0.5,0.8652694610778443,0.22413793103448276,0.956953642384106,0.30952380952380953,0.9088050314465409,348,1812,1734,78,270,78,0.8388888888888889,0.5905457867092944,0.5905457867092944
5,0,74,0.4970414201183432,0.8633852335509794,0.23595505617977527,0.9528824833702882,0.32,0.9059288537549408,356,1804,1719,85,272,84,0.8347222222222223,0.5944187697750317,0.5944187697750318
5,0,75,0.47126436781609193,0.8710976837865055,0.24260355029585798,0.9495060373216246,0.3203125,0.9086134453781513,338,1822,1730,92,256,82,0.8388888888888889,0.5960547938087413,0.5960547938087413
5,0,76,0.48484848484848486,0.8696741854636592,0.23529411764705882,0.9532967032967034,0.31683168316831684,0.90956749672346,340,1820,1735,85,260,80,0.8402777777777778,0.5942954104718811,0.5942954104718812
5,0,77,0.5146198830409356,0.869281045751634,0.25287356321839083,0.9541942604856513,0.33911368015414256,0.9097605893186004,348,1812,1729,83,260,88,0.8412037037037037,0.603533911852021,0.603533911852021
5,0,78,0.5144508670520231,0.8766985405133367,0.26646706586826346,0.9539978094194962,0.3510848126232742,0.9137162339365329,334,1826,1742,84,245,89,0.8476851851851852,0.6102324376438799,0.6102324376438799
5,0,79,0.4971751412429379,0.8719112455874937,0.2573099415204678,0.9510451045104511,0.3391136801541425,0.9097605893186003,342,1818,1729,89,254,88,0.8412037037037037,0.6041775230154595,0.6041775230154595
5,0,80,0.45930232558139533,0.869215291750503,0.23303834808259588,0.9489291598023064,0.30919765166340507,0.9073247571541087,339,1821,1728,93,260,79,0.836574074074074,0.5909837539424512,0.5909837539424511
5,0,81,0.4656084656084656,0.8731608320649417,0.2603550295857988,0.9445664105378705,0.33396584440227706,0.9074611125757975,338,1822,1721,101,250,88,0.8375,0.6024607200618347,0.6024607200618346
5,0,82,0.4853801169590643,0.8657616892911011,0.23714285714285716,0.9513812154696133,0.31861804222648754,0.9065543564095815,350,1810,1722,88,267,83,0.8356481481481481,0.5942620363062352,0.5942620363062352
5,0,83,0.5095541401273885,0.8691962056914628,0.23391812865497075,0.9576457645764577,0.32064128256513025,0.9112797696937974,342,1818,1741,77,262,80,0.8430555555555556,0.5957819466157143,0.5957819466157142
5,0,84,0.5235294117647059,0.8658291457286432,0.25,0.95509977827051,0.33840304182509506,0.9082762256193991,356,1804,1723,81,267,89,0.8388888888888889,0.602549889135255,0.602549889135255
5,0,85,0.5085714285714286,0.87455919395466,0.26331360946745563,0.9527991218441273,0.3469785575048733,0.9120042027843446,338,1822,1736,86,249,89,0.8449074074074074,0.6080563656557915,0.6080563656557915
5,0,86,0.47023809523809523,0.8689759036144579,0.2323529411764706,0.951098901098901,0.3110236220472441,0.9081846799580272,340,1820,1731,89,261,79,0.8379629629629629,0.5917259211376859,0.5917259211376859
5,0,87,0.4943820224719101,0.8718466195761857,0.2573099415204678,0.9504950495049505,0.3384615384615384,0.9094736842105264,342,1818,1728,90,254,88,0.8407407407407408,0.6039024955127091,0.6039024955127091
5,0,88,0.48214285714285715,0.8689759036144579,0.23684210526315788,0.9521452145214522,0.3176470588235294,0.9086614173228347,342,1818,1731,87,261,81,0.8388888888888889,0.5944936598923051,0.5944936598923051
5,0,89,0.4945054945054945,0.8725985844287159,0.2631578947368421,0.9493949394939494,0.3435114503816794,0.9093782929399368,342,1818,1726,92,252,90,0.8407407407407408,0.6062764171153957,0.6062764171153958
5,0,90,0.49710982658959535,0.8661298439859084,0.24431818181818182,0.9518805309734514,0.32761904761904764,0.9069828722002636,352,1808,1721,87,266,86,0.836574074074074,0.5980993563958166,0.5980993563958166
5,0,91,0.4748603351955307,0.8712771327612318,0.25,0.9483516483516483,0.32755298651252407,0.9081820573533281,340,1820,1726,94,255,85,0.8384259259259259,0.5991758241758242,0.5991758241758242
5,0,92,0.525,0.868,0.2413793103448276,0.9580573951434879,0.3307086614173228,0.9108079748163693,348,1812,1736,76,264,84,0.8425925925925926,0.5997183527441577,0.5997183527441577
5,0,93,0.483695652173913,0.8663967611336032,0.2521246458923513,0.9474266740453791,0.3314711359404097,0.9051017710811524,353,1807,1712,95,264,89,0.8337962962962963,0.5997756599688652,0.5997756599688652
5,0,94,0.4727272727272727,0.8706766917293233,0.23214285714285715,0.9523026315789473,0.31137724550898205,0.9096622152395916,336,1824,1737,87,258,78,0.8402777777777778,0.5922227443609023,0.5922227443609022
5,0,95,0.48214285714285715,0.8679718875502008,0.23546511627906977,0.9520925110132159,0.31640625,0.9080882352941176,344,1816,1729,87,263,81,0.8379629629629629,0.5937788136461428,0.5937788136461428
5,0,96,0.46551724137931033,0.8716012084592145,0.24107142857142858,0.9490131578947368,0.31764705882352945,0.9086614173228346,336,1824,1731,93,255,81,0.8388888888888889,0.5950422932330828,0.5950422932330827
5,0,97,0.49404761904761907,0.8674698795180723,0.23919308357348704,0.9531163816878102,0.32233009708737864,0.9082785808147175,347,1813,1728,85,264,83,0.8384259259259259,0.5961547326306487,0.5961547326306487
5,0,98,0.4540540540540541,0.8703797468354431,0.24705882352941178,0.9445054945054945,0.32,0.9059288537549407,340,1820,1719,101,256,84,0.8347222222222223,0.5957821590174531,0.5957821590174531
5,0,99,0.5146198830409356,0.8702865761689291,0.2543352601156069,0.954244762954796,0.3404255319148936,0.9103339468840389,346,1814,1731,83,258,88,0.8421296296296297,0.6042900115352015,0.6042900115352015
7,0,0,0.5826771653543307,0.8686669945892769,0.21700879765395895,0.9708631115997801,0.3162393162393162,0.9169262720664589,341,1819,1766,53,267,74,0.8518518518518519,0.5939359546268695,0.5939359546268695
7,0,1,0.5426356589147286,0.8665681930083703,0.20527859237536658,0.9675645959318306,0.2978723404255319,0.9142857142857141,341,1819,1760,59,271,70,0.8472222222222222,0.5864215941535986,0.5864215941535986
7,0,2,0.5070422535211268,0.873637264618434,0.22018348623853212,0.9618112384069831,0.3070362473347548,0.915606336016619,327,1833,1763,70,255,72,0.8495370370370371,0.5909973623227576,0.5909973623227576
7,0,3,0.556390977443609,0.8663048840651209,0.2144927536231884,0.9674931129476584,0.30962343096234307,0.9141072358146799,345,1815,1756,59,271,74,0.8472222222222222,0.5909929332854233,0.5909929332854233
7,0,4,0.5766423357664233,0.8680177953534355,0.22832369942196531,0.9680264608599779,0.32712215320910976,0.9152984102163149,346,1814,1756,58,267,79,0.8495370370370371,0.5981750801409716,0.5981750801409715
7,0,5,0.5104895104895105,0.8671294000991572,0.21407624633431085,0.9615173172072567,0.30165289256198347,0.9118873826903026,341,1819,1749,70,268,73,0.8435185185185186,0.5877967817707838,0.5877967817707838
7,0,6,0.5648854961832062,0.8649581074420897,0.21264367816091953,0.9685430463576159,0.3089770354906054,0.9138245248633168,348,1812,1755,57,274,74,0.8467592592592592,0.5905933622592677,0.5905933622592677
7,0,7,0.5419847328244275,0.8679152291769344,0.20943952802359883,0.9670510708401977,0.3021276595744681,0.9148051948051947,339,1821,1761,60,268,71,0.8481481481481481,0.5882452994318983,0.5882452994318983
7,0,8,0.5733333333333334,0.8696517412935323,0.2471264367816092,0.9646799116997793,0.3453815261044177,0.9147043432757719,348,1812,1748,64,262,86,0.8490740740740741,0.6059031742406943,0.6059031742406942
7,0,9,0.5658914728682171,0.8650910881339242,0.21037463976945245,0.9691119691119691,0.3067226890756303,0.9141519250780437,347,1813,1757,56,274,73,0.8472222222222222,0.5897433044407108,0.5897433044407108
7,0,10,0.5118110236220472,0.8657156910969012,0.19230769230769232,0.9659714599341384,0.2795698924731183,0.913099870298314,338,1822,1760,62,273,65,0.8449074074074074,0.5791395761209153,0.5791395761209154
7,0,11,0.5486111111111112,0.8695436507936508,0.2309941520467836,0.9642464246424642,0.32510288065843623,0.9144496609285341,342,1818,1753,65,263,79,0.8481481481481481,0.5976202883446239,0.597620288344624
7,0,12,0.6056338028169014,0.8696729435084242,0.24641833810888253,0.9690778575372723,0.35030549898167,0.916688430399582,349,1811,1755,56,263,86,0.8523148148148149,0.6077480978230774,0.6077480978230774
7,0,13,0.5620437956204379,0.8695007414730598,0.22580645161290322,0.9670148433205058,0.32217573221757323,0.9156689224362312,341,1819,1759,60,264,77,0.85,0.5964106474667046,0.5964106474667045
7,0,14,0.5693430656934306,0.8670291646070193,0.22478386167146974,0.9674572531715389,0.3223140495867769,0.9144942648592285,347,1813,1754,59,269,78,0.8481481481481481,0.5961205574215043,0.5961205574215043
7,0,15,0.5661764705882353,0.8690711462450593,0.22514619883040934,0.9675467546754676,0.32217573221757323,0.9156689224362311,342,1818,1759,59,265,77,0.85,0.5963464767529385,0.5963464767529384
7,0,16,0.5886524822695035,0.8741951461119366,0.24629080118694363,0.968184311574328,0.3472803347280335,0.9187922956793336,337,1823,1765,58,254,83,0.8555555555555555,0.6072375563806358,0.6072375563806358
7,0,17,0.5789473684210527,0.8677849037987173,0.22318840579710145,0.9691460055096419,0.32217573221757323,0.9156689224362311,345,1815,1759,56,268,77,0.85,0.5961672056533717,0.5961672056533717
7,0,18,0.5461538461538461,0.865024630541872,0.20579710144927535,0.9674931129476584,0.29894736842105263,0.9133940182054617,345,1815,1756,59,274,71,0.8458333333333333,0.586645107198467,0.5866451071984669
7,0,19,0.539568345323741,0.8659079663532905,0.21676300578034682,0.9647188533627343,0.30927835051546393,0.9126466753585397,346,1814,1750,64,271,75,0.8449074074074074,0.5907409295715407,0.5907409295715406
7,0,20,0.5441176470588235,0.866600790513834,0.21511627906976744,0.9658590308370044,0.3083333333333333,0.9135416666666667,344,1816,1754,62,270,74,0.8462962962962963,0.590487654953386,0.590487654953386
7,0,21,0.5766423357664233,0.865546218487395,0.22507122507122507,0.9679380873410725,0.3237704918032786,0.9138830897703549,351,1809,1751,58,272,79,0.8472222222222222,0.5965046562061487,0.5965046562061488
7,0,22,0.5606060606060606,0.866370808678501,0.2144927536231884,0.9680440771349862,0.310272536687631,0.9143897996357013,345,1815,1757,58,271,74,0.8476851851851852,0.5912684153790874,0.5912684153790873
7,0,23,0.5620437956204379,0.8675234799802274,0.22318840579710145,0.9669421487603306,0.3195020746887967,0.914538822303283,345,1815,1755,60,268,77,0.8481481481481481,0.595065277278716,0.5950652772787159
7,0,24,0.5869565217391305,0.8699307616221563,0.23546511627906977,0.9686123348017621,0.3360995850622407,0.9166232412714956,344,1816,1759,57,263,81,0.8518518518518519,0.6020387255404159,0.6020387255404159
7,0,25,0.5547445255474452,0.8680177953534355,0.22157434402332363,0.9664281783159053,0.31666666666666665,0.9145833333333333,343,1817,1756,61,267,76,0.8481481481481481,0.5940012611696145,0.5940012611696145
7,0,26,0.5379310344827586,0.8729528535980149,0.23353293413173654,0.9633077765607886,0.325678496868476,0.9159073158031762,334,1826,1759,67,256,78,0.850462962962963,0.5984203553462625,0.5984203553462626
7,0,27,0.5693430656934306,0.870489372219476,0.22941176470588234,0.9675824175824176,0.3270440251572327,0.9164715066354412,340,1820,1761,59,262,78,0.8513888888888889,0.59849709114415,0.59849709114415
7,0,28,0.5905511811023622,0.8637481554353172,0.21306818181818182,0.9712389380530974,0.31315240083507306,0.9143452225982817,352,1808,1756,52,277,75,0.8476851851851852,0.5921535599356397,0.5921535599356396
7,0,29,0.56,0.8624078624078624,0.2,0.9696132596685083,0.2947368421052632,0.9128738621586476,350,1810,1755,55,280,70,0.8449074074074074,0.5848066298342541,0.5848066298342541
7,0,30,0.5671641791044776,0.8647581441263573,0.21714285714285714,0.9679558011049724,0.31404958677685946,0.913451511991658,350,1810,1752,58,274,76,0.8462962962962963,0.5925493291239148,0.5925493291239148
7,0,31,0.6033057851239669,0.8612064737616478,0.2050561797752809,0.9733924611973392,0.3060796645702306,0.9138693728857663,356,1804,1756,48,283,73,0.8467592592592592,0.58922432048631,0.5892243204863101
7,0,32,0.5170068027210885,0.8683556880278192,0.22287390029325513,0.9609675645959318,0.3114754098360656,0.9123173277661796,341,1819,1748,71,265,76,0.8444444444444444,0.5919207324445935,0.5919207324445934
7,0,33,0.5460992907801419,0.866765725606736,0.22254335260115607,0.9647188533627343,0.31622176591375767,0.9131228802504566,346,1814,1750,64,269,77,0.8458333333333333,0.5936311029819452,0.5936311029819452
7,0,34,0.5217391304347826,0.8679525222551929,0.21238938053097345,0.9637561779242174,0.3018867924528302,0.9133489461358314,339,1821,1755,66,267,72,0.8458333333333333,0.5880727792275954,0.5880727792275955
7,0,35,0.5648854961832062,0.8693937900443568,0.2182890855457227,0.9686985172981878,0.3148936170212766,0.9163636363636363,339,1821,1764,57,265,74,0.850925925925926,0.5934938014219553,0.5934938014219552
7,0,36,0.5454545454545454,0.8753738783649053,0.25149700598802394,0.9616648411829135,0.3442622950819672,0.9164926931106472,334,1826,1756,70,250,84,0.8518518518518519,0.6065809235854687,0.6065809235854687
7,0,37,0.5488721804511278,0.8623581647755303,0.20738636363636365,0.9668141592920354,0.30103092783505153,0.9116036505867013,352,1808,1748,60,279,73,0.8430555555555556,0.5871002614641996,0.5871002614641995
7,0,38,0.5639097744360902,0.8672915638875185,0.2180232558139535,0.9680616740088106,0.31446540880503143,0.9149102263856362,344,1816,1758,58,269,75,0.8486111111111111,0.593042464911382,0.5930424649113821
7,0,39,0.5378787878787878,0.863905325443787,0.20461095100864554,0.9663541092112521,0.2964509394572025,0.9122624316584224,347,1813,1752,61,276,71,0.8439814814814814,0.5854825301099489,0.5854825301099489
7,0,40,0.5514705882352942,0.8656126482213439,0.21613832853025935,0.9663541092112521,0.3105590062111801,0.9132134480062549,347,1813,1752,61,272,75,0.8458333333333333,0.5912462188707558,0.5912462188707557
7,0,41,0.5877862595419847,0.8708723509117792,0.22713864306784662,0.9703459637561779,0.32765957446808514,0.9179220779220779,339,1821,1767,54,262,77,0.8537037037037037,0.5987423034120122,0.5987423034120123
7,0,42,0.5419847328244275,0.8679152291769344,0.20943952802359883,0.9670510708401977,0.3021276595744681,0.9148051948051947,339,1821,1761,60,268,71,0.8481481481481481,0.5882452994318983,0.5882452994318983
7,0,43,0.5102040816326531,0.8713363139592648,0.2245508982035928,0.9605695509309967,0.31185031185031187,0.9137796301120084,334,1826,1754,72,259,75,0.8467592592592592,0.5925602245672948,0.5925602245672948
7,0,44,0.5234899328859061,0.8687220288413725,0.22807017543859648,0.9609460946094609,0.3177189409368636,0.912509793679812,342,1818,1747,71,264,78,0.8449074074074074,0.5945081350240287,0.5945081350240287
7,0,45,0.5461538461538461,0.8655172413793103,0.2063953488372093,0.9675110132158591,0.29957805907172996,0.9136765470618825,344,1816,1757,59,273,71,0.8462962962962963,0.5869531810265342,0.5869531810265342
7,0,46,0.5625,0.8700787401574803,0.21428571428571427,0.9692982456140351,0.31034482758620685,0.9170124481327802,336,1824,1768,56,264,72,0.8518518518518519,0.5917919799498746,0.5917919799498746
7,0,47,0.562962962962963,0.8666666666666667,0.21965317919075145,0.9674751929437707,0.316008316008316,0.9143005991143527,346,1814,1755,59,270,76,0.8476851851851852,0.593564186067261,0.593564186067261
7,0,48,0.5367647058823529,0.8651185770750988,0.21098265895953758,0.9652701212789415,0.30290456431535273,0.9124544033350703,346,1814,1751,63,273,73,0.8444444444444444,0.5881263901192396,0.5881263901192395
7,0,49,0.5785123966942148,0.8700343305541932,0.208955223880597,0.972054794520548,0.3070175438596491,0.9182194616977226,335,1825,1774,51,265,70,0.8537037037037037,0.5905050092005725,0.5905050092005726
7,0,50,0.5426356589147286,0.8665681930083703,0.20527859237536658,0.9675645959318306,0.2978723404255319,0.9142857142857141,341,1819,1760,59,271,70,0.8472222222222222,0.5864215941535986,0.5864215941535986
7,0,51,0.5328467153284672,0.8699950568462679,0.21726190476190477,0.9649122807017544,0.3086680761099366,0.914998700285937,336,1824,1760,64,263,73,0.8486111111111111,0.5910870927318296,0.5910870927318296
7,0,52,0.5234899328859061,0.8712083540527101,0.2314540059347181,0.9610532089961602,0.3209876543209877,0.9139280125195618,337,1823,1752,71,259,78,0.8472222222222222,0.5962536074654391,0.5962536074654392
7,0,53,0.5579710144927537,0.8699307616221563,0.22647058823529412,0.9664835164835165,0.32217573221757323,0.9156689224362312,340,1820,1759,61,263,77,0.85,0.5964770523594053,0.5964770523594053
7,0,54,0.5259259259259259,0.8701234567901235,0.2125748502994012,0.9649507119386638,0.302771855010661,0.9150869903921061,334,1826,1762,64,263,71,0.8486111111111111,0.5887627811190325,0.5887627811190325
7,0,55,0.5416666666666666,0.8700396825396826,0.22941176470588234,0.9637362637362638,0.32231404958677684,0.9144942648592284,340,1820,1754,66,262,78,0.8481481481481481,0.5965740142210731,0.596574014221073
7,0,56,0.5111111111111111,0.8671604938271605,0.20414201183431951,0.9637760702524698,0.29175475687103586,0.9129191577852872,338,1822,1756,66,269,69,0.8449074074074074,0.5839590410433947,0.5839590410433947
7,0,57,0.5211267605633803,0.8701684836471755,0.22023809523809523,0.9627192982456141,0.30962343096234307,0.9141072358146799,336,1824,1756,68,262,74,0.8472222222222222,0.5914786967418547,0.5914786967418546
7,0,58,0.5488721804511278,0.8672915638875185,0.2134502923976608,0.966996699669967,0.30736842105263157,0.9144343302990897,342,1818,1758,60,269,73,0.8476851851851852,0.590223496033814,0.590223496033814
7,0,59,0.5434782608695652,0.8674579624134521,0.21865889212827988,0.965327462850853,0.3118503118503118,0.9137796301120085,343,1817,1754,63,268,75,0.8467592592592592,0.5919931774895665,0.5919931774895665
7,0,60,0.5661764705882353,0.8695652173913043,0.22580645161290322,0.9675645959318306,0.32285115303983225,0.9159510798855061,341,1819,1760,59,264,77,0.850462962962963,0.5966855237723669,0.5966855237723669
7,0,61,0.5328467153284672,0.865546218487395,0.21159420289855072,0.9647382920110192,0.3029045643153527,0.9124544033350703,345,1815,1751,64,272,73,0.8444444444444444,0.588166247454785,0.588166247454785
7,0,62,0.5306122448979592,0.8633879781420765,0.22096317280453256,0.9618151632540122,0.312,0.9099476439790576,353,1807,1738,69,275,78,0.8407407407407408,0.5913891680292723,0.5913891680292724
7,0,63,0.5546875,0.8651574803149606,0.20579710144927535,0.968595041322314,0.30021141649048627,0.913958929035612,345,1815,1758,57,274,71,0.8467592592592592,0.5871960713857947,0.5871960713857947
7,0,64,0.5422535211267606,0.8686818632309217,0.22514619883040934,0.9642464246424642,0.3181818181818182,0.9139728884254432,342,1818,1753,65,265,77,0.8472222222222222,0.5946963117364368,0.5946963117364368
7,0,65,0.539568345323741,0.8703612073231074,0.22255192878338279,0.9648930334613275,0.31512605042016806,0.9151925078043704,337,1823,1759,64,262,75,0.8490740740740741,0.5937224811223552,0.5937224811223552
7,0,66,0.5362318840579711,0.8694362017804155,0.21893491124260356,0.964873765093304,0.31092436974789917,0.9146722164412071,338,1822,1758,64,264,74,0.8481481481481481,0.5919043381679537,0.5919043381679538
7,0,67,0.5271317829457365,0.8645987198424422,0.19825072886297376,0.9664281783159053,0.288135593220339,0.9126819126819128,343,1817,1756,61,275,68,0.8444444444444444,0.5823394535894395,0.5823394535894395
7,0,68,0.5333333333333333,0.8681481481481481,0.21238938053097345,0.9654036243822076,0.3037974683544304,0.9141965678627145,339,1821,1758,63,267,72,0.8472222222222222,0.5888965024565905,0.5888965024565905
7,0,69,0.5634920634920635,0.8687315634218289,0.21005917159763313,0.9698133918770582,0.30603448275862066,0.9164937759336099,338,1822,1767,55,267,71,0.850925925925926,0.5899362817373457,0.5899362817373457
7,0,70,0.556390977443609,0.868771583621115,0.21764705882352942,0.9675824175824176,0.3128964059196617,0.9155185859110997,340,1820,1761,59,266,74,0.8495370370370371,0.5926147382029736,0.5926147382029735
7,0,71,0.5522388059701493,0.8647581441263573,0.21264367816091953,0.9668874172185431,0.30705394190871366,0.9129755080771236,348,1812,1752,60,274,74,0.8453703703703703,0.5897655476897313,0.5897655476897313
7,0,72,0.56,0.8663390663390663,0.2046783625730994,0.9697469746974697,0.29978586723768735,0.9151310667012716,342,1818,1763,55,272,70,0.8486111111111111,0.5872126686352847,0.5872126686352845
7,0,73,0.553030303030303,0.8678500986193294,0.21407624633431085,0.9675645959318306,0.3086680761099366,0.9149987002859371,341,1819,1760,59,268,73,0.8486111111111111,0.5908204211330708,0.5908204211330708
7,0,74,0.5511811023622047,0.8671913428430891,0.20588235294117646,0.9686813186813187,0.29978586723768735,0.9151310667012716,340,1820,1763,57,270,70,0.8486111111111111,0.5872818358112475,0.5872818358112476
7,0,75,0.5384615384615384,0.8669950738916257,0.20588235294117646,0.967032967032967,0.2978723404255319,0.9142857142857144,340,1820,1760,60,270,70,0.8472222222222222,0.5864576599870717,0.5864576599870718
7,0,76,0.5748031496062992,0.8637481554353172,0.20857142857142857,0.9701657458563536,0.3060796645702306,0.9138693728857663,350,1810,1756,54,277,73,0.8467592592592592,0.5893685872138912,0.5893685872138911
7,0,77,0.525,0.8647058823529412,0.18584070796460178,0.9686985172981878,0.27450980392156865,0.9137529137529138,339,1821,1764,57,276,63,0.8458333333333333,0.5772696126313948,0.5772696126313948
7,0,78,0.5072463768115942,0.8630069238377843,0.2017291066282421,0.9624931053502482,0.288659793814433,0.910039113428944,347,1813,1745,68,277,70,0.8402777777777778,0.5821111059892451,0.5821111059892452
7,0,79,0.5244755244755245,0.8676251859196827,0.21929824561403508,0.9625962596259626,0.30927835051546393,0.9126466753585398,342,1818,1750,68,267,75,0.8449074074074074,0.5909472526199989,0.5909472526199988
7,0,80,0.5639097744360902,0.8672915638875185,0.2180232558139535,0.9680616740088106,0.31446540880503143,0.9149102263856362,344,1816,1758,58,269,75,0.8486111111111111,0.593042464911382,0.5930424649113821
7,0,81,0.5588235294117647,0.8670948616600791,0.22028985507246376,0.9669421487603306,0.316008316008316,0.9143005991143527,345,1815,1755,60,269,76,0.8476851851851852,0.5936160019163972,0.5936160019163972
7,0,82,0.5597014925373134,0.8652517275419546,0.21551724137931033,0.967439293598234,0.3112033195020747,0.9134966128191766,348,1812,1753,59,273,75,0.8462962962962963,0.5914782674887721,0.5914782674887722
7,0,83,0.5524475524475524,0.8691125433812593,0.2303206997084548,0.9647771051183269,0.32510288065843623,0.9144496609285343,343,1817,1753,64,264,79,0.8481481481481481,0.5975489024133909,0.5975489024133909
7,0,84,0.5639097744360902,0.871238283177109,0.22321428571428573,0.9682017543859649,0.31982942430703626,0.9171643728901584,336,1824,1766,58,261,75,0.8523148148148149,0.5957080200501254,0.5957080200501252
7,0,85,0.5546218487394958,0.8672219500244978,0.19584569732937684,0.9709270433351618,0.28947368421052627,0.9161490683229814,337,1823,1770,53,271,66,0.85,0.5833863703322693,0.5833863703322694
7,0,86,0.5422535211267606,0.8681863230921705,0.22448979591836735,0.9642267473858007,0.31752577319587627,0.913689700130378,343,1817,1752,65,266,77,0.8467592592592592,0.594358271652084,0.5943582716520841
7,0,87,0.5538461538461539,0.8635467980295567,0.20630372492836677,0.9679734953064605,0.30062630480167013,0.9127831293933872,349,1811,1753,58,277,72,0.8449074074074074,0.5871386101174136,0.5871386101174136
7,0,88,0.5294117647058824,0.866600790513834,0.21052631578947367,0.9647964796479648,0.301255230125523,0.9130661114003125,342,1818,1754,64,270,72,0.8453703703703703,0.5876613977187193,0.5876613977187193
7,0,89,0.5174825174825175,0.8701041150223103,0.22023809523809523,0.962171052631579,0.3089770354906054,0.9138245248633169,336,1824,1755,69,262,74,0.8467592592592592,0.5912045739348372,0.591204573934837
7,0,90,0.55,0.8663366336633663,0.2219020172910663,0.9652509652509652,0.3162217659137577,0.9131228802504565,347,1813,1750,63,270,77,0.8458333333333333,0.5935764912710157,0.5935764912710157
7,0,91,0.5481481481481482,0.8701234567901235,0.2195845697329377,0.9665386725178278,0.3135593220338983,0.9158004158004158,337,1823,1762,61,263,74,0.85,0.5930616211253827,0.5930616211253827
7,0,92,0.5461538461538461,0.867487684729064,0.2088235294117647,0.9675824175824176,0.3021276595744681,0.9148051948051948,340,1820,1761,59,269,71,0.8481481481481481,0.5882029734970912,0.5882029734970912
7,0,93,0.5384615384615384,0.8701041150223103,0.22713864306784662,0.9637561779242174,0.3195020746887967,0.9145388223032829,339,1821,1755,66,262,77,0.8481481481481481,0.595447410496032,0.595447410496032
7,0,94,0.556390977443609,0.8663048840651209,0.2144927536231884,0.9674931129476584,0.30962343096234307,0.9141072358146799,345,1815,1756,59,271,74,0.8472222222222222,0.5909929332854233,0.5909929332854233
7,0,95,0.5441176470588235,0.8656126482213439,0.2138728323699422,0.9658213891951488,0.30705394190871366,0.9129755080771235,346,1814,1752,62,272,74,0.8453703703703703,0.5898471107825455,0.5898471107825455
7,0,96,0.5036496350364964,0.8709836875926842,0.20909090909090908,0.9628415300546448,0.29550321199143464,0.9146119906566311,330,1830,1762,68,261,69,0.8476851851851852,0.5859662195727768,0.585966219572777
7,0,97,0.572463768115942,0.8659742828882295,0.2257142857142857,0.967403314917127,0.32377049180327866,0.9138830897703549,350,1810,1751,59,271,79,0.8472222222222222,0.5965588003157064,0.5965588003157064
7,0,98,0.5441176470588235,0.866600790513834,0.21511627906976744,0.9658590308370044,0.3083333333333333,0.9135416666666667,344,1816,1754,62,270,74,0.8462962962962963,0.590487654953386,0.590487654953386
7,0,99,0.5639097744360902,0.8623581647755303,0.211864406779661,0.9678848283499446,0.3080082135523614,0.912079311244456,354,1806,1748,58,279,75,0.8439814814814814,0.5898746175648028,0.5898746175648028
9,0,0,0.6,0.8668292682926829,0.19469026548672566,0.9758374519494784,0.29398663697104677,0.9181090157582019,339,1821,1777,44,273,66,0.8532407407407407,0.585263858718102,0.585263858718102
9,0,1,0.6120689655172413,0.8718199608610567,0.2132132132132132,0.9753694581280788,0.31625835189309576,0.920692327563937,333,1827,1782,45,262,71,0.8578703703703704,0.5942913356706461,0.5942913356706461
9,0,2,0.5785123966942148,0.868563021088769,0.20710059171597633,0.9720087815587267,0.30501089324618735,0.9173789173789174,338,1822,1771,51,268,70,0.8523148148148149,0.5895546866373516,0.5895546866373516
9,0,3,0.6260869565217392,0.8665036674816626,0.20869565217391303,0.9763085399449036,0.3130434782608696,0.9181347150259068,345,1815,1772,43,273,72,0.8537037037037037,0.5925020960594083,0.5925020960594083
9,0,4,0.5785123966942148,0.8666012751348701,0.2046783625730994,0.971947194719472,0.3023758099352052,0.9162561576354681,342,1818,1767,51,272,70,0.850462962962963,0.5883127786462857,0.5883127786462857
9,0,5,0.6074766355140186,0.8626400389673649,0.1873198847262248,0.9768339768339769,0.2863436123348018,0.9161924469736162,347,1813,1771,42,282,65,0.85,0.5820769307801008,0.5820769307801008
9,0,6,0.5945945945945946,0.8633479746217667,0.1907514450867052,0.9751929437706726,0.28884026258205686,0.9158684959875745,346,1814,1769,45,280,66,0.8495370370370371,0.5829721944286889,0.5829721944286889
9,0,7,0.5793650793650794,0.8667649950835792,0.21220930232558138,0.9708149779735683,0.31063829787234043,0.9158441558441558,344,1816,1763,53,271,73,0.85,0.5915121401495749,0.5915121401495749
9,0,8,0.5964912280701754,0.8651026392961877,0.19767441860465115,0.974669603524229,0.296943231441048,0.9166235111341274,344,1816,1770,46,276,68,0.850925925925926,0.5861720110644401,0.5861720110644401
9,0,9,0.6,0.8661800486618005,0.1863905325443787,0.9769484083424808,0.28442437923250563,0.9182357492906887,338,1822,1780,42,275,63,0.8532407407407407,0.5816694704434296,0.5816694704434298
9,0,10,0.6173913043478261,0.8665036674816626,0.2063953488372093,0.9757709251101322,0.3093681917211329,0.9178969178969179,344,1816,1772,44,273,71,0.8532407407407407,0.5910831369736707,0.5910831369736708
9,0,11,0.6132075471698113,0.8622200584225901,0.1867816091954023,0.9773730684326711,0.28634361233480177,0.9161924469736162,348,1812,1771,41,283,65,0.85,0.5820773388140367,0.5820773388140368
9,0,12,0.6160714285714286,0.865234375,0.2,0.9763085399449036,0.3019693654266959,0.9174216929847269,345,1815,1772,43,276,69,0.8523148148148149,0.5881542699724518,0.5881542699724518
9,0,13,0.5849056603773585,0.8685491723466408,0.18674698795180722,0.975929978118162,0.2831050228310502,0.9191138588356519,332,1828,1784,44,270,62,0.8546296296296296,0.5813384830349847,0.5813384830349846
9,0,14,0.6052631578947368,0.8660801564027371,0.20116618075801748,0.9752339020363237,0.3019693654266958,0.9174216929847269,343,1817,1772,45,274,69,0.8523148148148149,0.5882000413971705,0.5882000413971706
9,0,15,0.5789473684210527,0.863147605083089,0.1907514450867052,0.9735391400220507,0.28695652173913044,0.9150259067357513,346,1814,1766,48,280,66,0.8481481481481481,0.5821452925543779,0.582145292554378
9,0,16,0.6140350877192983,0.8704789833822092,0.208955223880597,0.9758904109589042,0.311804008908686,0.92017566520279,335,1825,1781,44,265,70,0.8569444444444444,0.5924228174197506,0.5924228174197507
9,0,17,0.5726495726495726,0.8668624571708272,0.1976401179941003,0.9725425590334981,0.293859649122807,0.9166666666666666,339,1821,1771,50,272,67,0.850925925925926,0.5850913385137992,0.5850913385137992
9,0,18,0.6140350877192983,0.8660801564027371,0.20348837209302326,0.9757709251101322,0.3056768558951965,0.9176592439150699,344,1816,1772,44,274,70,0.8527777777777777,0.5896296486015777,0.5896296486015777
9,0,19,0.5818181818181818,0.864390243902439,0.1871345029239766,0.9746974697469747,0.2831858407079646,0.9162357807652534,342,1818,1772,46,278,64,0.85,0.5809159863354756,0.5809159863354756
9,0,20,0.6,0.8656934306569343,0.18584070796460178,0.9769357495881383,0.2837837837837838,0.9179566563467492,339,1821,1779,42,276,63,0.8527777777777777,0.5813882287763701,0.58138822877637
9,0,21,0.6239316239316239,0.8653940283896231,0.20977011494252873,0.9757174392935982,0.3139784946236559,0.9172503242542154,348,1812,1768,44,275,73,0.8523148148148149,0.5927437771180635,0.5927437771180635
9,0,22,0.5865384615384616,0.8662451361867705,0.18154761904761904,0.9764254385964912,0.2772727272727272,0.918041237113402,336,1824,1781,43,275,61,0.8527777777777777,0.5789865288220551,0.5789865288220551
9,0,23,0.6194690265486725,0.8593063019052272,0.19553072625698323,0.9761376248612652,0.29723991507430997,0.9140036373083918,358,1802,1759,43,288,70,0.8467592592592592,0.5858341755591242,0.5858341755591242
9,0,24,0.5925925925925926,0.8703703703703703,0.19393939393939394,0.9759562841530055,0.2922374429223744,0.9201442555383823,330,1830,1786,44,266,64,0.8564814814814815,0.5849478390461997,0.5849478390461997
9,0,25,0.6146788990825688,0.863481228668942,0.1930835734870317,0.9768339768339769,0.29385964912280704,0.9166666666666666,347,1813,1771,42,280,67,0.850925925925926,0.5849587751605043,0.5849587751605042
9,0,26,0.5391304347826087,0.8694376528117359,0.1884498480243161,0.9710540688148552,0.27927927927927926,0.9174406604747162,329,1831,1778,53,267,62,0.8518518518518519,0.5797519584195857,0.5797519584195857
9,0,27,0.6095238095238096,0.8652068126520681,0.187683284457478,0.977460142935679,0.28699551569506726,0.917914300464636,341,1819,1778,41,277,64,0.8527777777777777,0.5825717136965786,0.5825717136965785
9,0,28,0.5726495726495726,0.8678414096916299,0.19881305637982197,0.9725726823916621,0.29515418502202645,0.91722710812209,337,1823,1773,50,270,67,0.8518518518518519,0.5856928693857419,0.5856928693857419
9,0,29,0.6083333333333333,0.8661764705882353,0.21098265895953758,0.974090407938258,0.31330472103004287,0.916969382459782,346,1814,1767,47,273,73,0.8518518518518519,0.5925365334488978,0.5925365334488978
9,0,30,0.5566037735849056,0.8607594936708861,0.17101449275362318,0.9741046831955923,0.26164079822616404,0.9139312483845955,345,1815,1768,47,286,59,0.8458333333333333,0.5725595879746077,0.5725595879746078
9,0,31,0.6016260162601627,0.865979381443299,0.2132564841498559,0.972972972972973,0.3148936170212766,0.9163636363636364,347,1813,1764,49,273,74,0.850925925925926,0.5931147285614146,0.5931147285614145
9,0,32,0.6272727272727273,0.8634146341463415,0.1977077363896848,0.97736057426836,0.3006535947712418,0.916860916860917,349,1811,1770,41,280,69,0.8513888888888889,0.5875341553290224,0.5875341553290224
9,0,33,0.5798319327731093,0.8686918177364037,0.20474777448071216,0.9725726823916621,0.3026315789473684,0.9177018633540371,337,1823,1773,50,268,69,0.8527777777777777,0.5886602284361871,0.588660228436187
9,0,34,0.625,0.869140625,0.20710059171597633,0.9769484083424808,0.3111111111111111,0.9198966408268733,338,1822,1780,42,268,70,0.8564814814814815,0.5920245000292285,0.5920245000292286
9,0,35,0.5855855855855856,0.8657881893606637,0.19117647058823528,0.9747252747252747,0.28824833702882485,0.9170328250193849,340,1820,1774,46,275,65,0.8513888888888889,0.5829508726567549,0.5829508726567549
9,0,36,0.5508474576271186,0.8653281096963761,0.19117647058823528,0.9708791208791209,0.2838427947598253,0.9150699119627137,340,1820,1767,53,275,65,0.8481481481481481,0.581027795733678,0.581027795733678
9,0,37,0.5714285714285714,0.8657520823125918,0.19883040935672514,0.971947194719472,0.2950108459869848,0.9157812904897642,342,1818,1767,51,274,68,0.8495370370370371,0.5853888020380985,0.5853888020380986
9,0,38,0.5982142857142857,0.85888671875,0.18820224719101122,0.9750554323725056,0.2863247863247863,0.9132917964693666,356,1804,1759,45,289,67,0.8453703703703703,0.5816288397817584,0.5816288397817584
9,0,39,0.6037735849056604,0.8617332035053554,0.1839080459770115,0.9768211920529801,0.2819383259911894,0.9156751163993792,348,1812,1770,42,284,64,0.8490740740740741,0.5803646190149958,0.5803646190149958
9,0,40,0.6213592233009708,0.8580456976178902,0.1797752808988764,0.9783813747228381,0.27886710239651413,0.9142709142709142,356,1804,1765,39,292,64,0.8467592592592592,0.5790783278108572,0.5790783278108573
9,0,41,0.6147540983606558,0.8680078508341511,0.2180232558139535,0.9741189427312775,0.3218884120171674,0.9180072651790347,344,1816,1769,47,269,75,0.8537037037037037,0.5960710992726155,0.5960710992726155
9,0,42,0.5634920634920635,0.8702064896755162,0.21194029850746268,0.9698630136986301,0.3080260303687635,0.9173360974345686,335,1825,1770,55,264,71,0.8523148148148149,0.5909016561030465,0.5909016561030465
9,0,43,0.6126126126126126,0.864812103465105,0.19710144927536233,0.9763085399449036,0.2982456140350877,0.917184265010352,345,1815,1772,43,277,68,0.8518518518518519,0.5867049946101329,0.586704994610133
9,0,44,0.5254237288135594,0.8643486777668952,0.18289085545722714,0.9692476661175179,0.27133479212253825,0.9137975666580379,339,1821,1765,56,277,62,0.8458333333333333,0.5760692607873724,0.5760692607873725
9,0,45,0.6213592233009708,0.859504132231405,0.1813031161473088,0.9784172661870504,0.2807017543859649,0.9151138716356109,353,1807,1768,39,289,64,0.8481481481481481,0.5798601911671797,0.5798601911671796
9,0,46,0.625,0.8701171875,0.20833333333333334,0.9769736842105263,0.3125,0.9204545454545454,336,1824,1782,42,266,70,0.8574074074074074,0.5926535087719298,0.5926535087719298
9,0,47,0.5630252100840336,0.8652621264086232,0.195906432748538,0.9713971397139713,0.29067245119305857,0.9152630215081626,342,1818,1766,52,275,67,0.8486111111111111,0.5836517862312547,0.5836517862312547
9,0,48,0.6415094339622641,0.8583252190847127,0.1894150417827298,0.9789006107717935,0.29247311827956984,0.9146562905317769,359,1801,1763,38,291,68,0.8476851851851852,0.5841578262772616,0.5841578262772616
9,0,49,0.5867768595041323,0.8675821481118196,0.20821114369501467,0.9725123694337549,0.3073593073593074,0.9170554691550026,341,1819,1769,50,270,71,0.8518518518518519,0.5903617565643848,0.5903617565643847
9,0,50,0.5526315789473685,0.8607038123167156,0.1810344827586207,0.9718543046357616,0.27272727272727276,0.9129082426127527,348,1812,1761,51,285,63,0.8444444444444444,0.5764443936971912,0.5764443936971911
9,0,51,0.576271186440678,0.8648383937316356,0.19767441860465115,0.9724669603524229,0.29437229437229434,0.9155002592016589,344,1816,1766,50,276,68,0.8490740740740741,0.5850706894785369,0.585070689478537
9,0,52,0.5964912280701754,0.863147605083089,0.19540229885057472,0.9746136865342163,0.2943722943722944,0.9155002592016589,348,1812,1766,46,280,68,0.8490740740740741,0.5850079926923956,0.5850079926923955
9,0,53,0.6018518518518519,0.8659844054580896,0.19117647058823528,0.9763736263736263,0.29017857142857145,0.9178719008264463,340,1820,1777,43,275,65,0.8527777777777777,0.5837750484809308,0.5837750484809308
9,0,54,0.6371681415929203,0.8661455788959452,0.20809248554913296,0.9773980154355016,0.3137254901960784,0.9184149184149184,346,1814,1773,41,274,72,0.8541666666666666,0.5927452504923174,0.5927452504923173
9,0,55,0.5794392523364486,0.8670238675109596,0.18507462686567164,0.9753424657534246,0.28054298642533937,0.9179989685404848,335,1825,1780,45,273,62,0.8527777777777777,0.5802085463095481,0.5802085463095481
9,0,56,0.631578947368421,0.8651026392961877,0.20689655172413793,0.9768211920529801,0.3116883116883117,0.9175738724727839,348,1812,1770,42,276,72,0.8527777777777777,0.591858871888559,0.591858871888559
9,0,57,0.5909090909090909,0.8648780487804878,0.19005847953216373,0.9752475247524752,0.28761061946902655,0.9167528438469493,342,1818,1773,45,277,65,0.850925925925926,0.5826530021423195,0.5826530021423194
9,0,58,0.6129032258064516,0.8659135559921415,0.2177650429799427,0.9734953064605191,0.3213530655391121,0.9165583571614244,349,1811,1763,48,273,76,0.8513888888888889,0.5956301747202308,0.5956301747202308
9,0,59,0.6,0.8648780487804878,0.1924198250728863,0.9757842597688497,0.2913907284768212,0.916989914662529,343,1817,1773,44,277,66,0.8513888888888889,0.584102042420868,0.584102042420868
9,0,60,0.5619834710743802,0.8641490926924963,0.19710144927536233,0.9707988980716253,0.2918454935622318,0.9143746756616502,345,1815,1762,53,277,68,0.8472222222222222,0.5839501736734938,0.5839501736734938
9,0,61,0.6033057851239669,0.8656204021579206,0.21037463976945245,0.9735245449531164,0.31196581196581197,0.9164070612668744,347,1813,1765,48,274,73,0.850925925925926,0.5919495923612843,0.5919495923612844
9,0,62,0.5963302752293578,0.8659190638712823,0.19117647058823528,0.9758241758241758,0.28953229398663693,0.917592353397055,340,1820,1776,44,275,65,0.8523148148148149,0.5835003232062055,0.5835003232062055
9,0,63,0.5855855855855856,0.8662762323084432,0.19174041297935104,0.9747391543108183,0.28888888888888886,0.917312661498708,339,1821,1775,46,274,65,0.8518518518518519,0.5832397836450847,0.5832397836450847
9,0,64,0.6140350877192983,0.8651026392961877,0.2023121387283237,0.9757442116868799,0.30434782608695654,0.917098445595855,346,1814,1770,44,276,70,0.8518518518518519,0.5890281752076019,0.5890281752076018
9,0,65,0.5254237288135594,0.8692458374142997,0.1884498480243161,0.969415619879847,0.27740492170022374,0.916602117221792,329,1831,1775,56,267,62,0.850462962962963,0.5789327339520817,0.5789327339520816
9,0,66,0.6,0.8611246943765282,0.1954674220963173,0.9745434421693414,0.2948717948717949,0.9143302180685359,353,1807,1761,46,284,69,0.8472222222222222,0.5850054321328293,0.5850054321328293
9,0,67,0.5862068965517241,0.8674168297455969,0.20058997050147492,0.9736408566721582,0.29890109890109884,0.917464424320828,339,1821,1773,48,271,68,0.8523148148148149,0.5871154135868165,0.5871154135868166
9,0,68,0.603448275862069,0.8649706457925636,0.2023121387283237,0.9746416758544653,0.303030303030303,0.9165370658372213,346,1814,1768,46,276,70,0.850925925925926,0.5884769072913945,0.5884769072913945
9,0,69,0.5950413223140496,0.8690534575772437,0.21238938053097345,0.9730917078528282,0.3130434782608696,0.9181347150259068,339,1821,1772,49,267,72,0.8537037037037037,0.5927405441919007,0.5927405441919008
9,0,70,0.5555555555555556,0.8688203622124328,0.19519519519519518,0.9715380405035577,0.2888888888888889,0.917312661498708,333,1827,1775,52,268,65,0.8518518518518519,0.5833666178493765,0.5833666178493765
9,0,71,0.6017699115044248,0.8646800195407914,0.19710144927536233,0.9752066115702479,0.29694323144104806,0.9166235111341274,345,1815,1770,45,277,68,0.850925925925926,0.586154030422805,0.5861540304228051
9,0,72,0.5862068965517241,0.8669275929549902,0.2,0.9736263736263736,0.2982456140350877,0.9171842650103521,340,1820,1772,48,272,68,0.8518518518518519,0.5868131868131867,0.5868131868131867
9,0,73,0.5614035087719298,0.8695014662756598,0.1933534743202417,0.9726626571897211,0.2876404494382023,0.9181935483870967,331,1829,1779,50,267,64,0.8532407407407407,0.5830080657549814,0.5830080657549814
9,0,74,0.6285714285714286,0.8652068126520681,0.1924198250728863,0.9785360484314805,0.29464285714285715,0.918388429752066,343,1817,1778,39,277,66,0.8537037037037037,0.5854779367521834,0.5854779367521834
9,0,75,0.5740740740740741,0.8630604288499025,0.18075801749271136,0.9746835443037974,0.2749445676274945,0.9154820367019901,343,1817,1771,46,281,62,0.8486111111111111,0.5777207808982544,0.5777207808982544
9,0,76,0.56,0.8678132678132678,0.20648967551622419,0.9697968149368479,0.3017241379310345,0.9159751037344398,339,1821,1766,55,269,70,0.85,0.588143245226536,0.588143245226536
9,0,77,0.6086956521739131,0.8655256723716381,0.2028985507246377,0.9752066115702479,0.30434782608695654,0.9170984455958548,345,1815,1770,45,275,70,0.8518518518518519,0.5890525811474429,0.5890525811474427
9,0,78,0.6551724137931034,0.8708414872798435,0.2235294117647059,0.978021978021978,0.33333333333333337,0.9213250517598343,340,1820,1780,40,264,76,0.8592592592592593,0.6007756948933419,0.6007756948933419
9,0,79,0.6016949152542372,0.8667972575905974,0.20699708454810495,0.9741331865712713,0.3080260303687635,0.9173360974345685,343,1817,1770,47,272,71,0.8523148148148149,0.5905651355596881,0.5905651355596881
9,0,80,0.5701754385964912,0.863147605083089,0.18840579710144928,0.9730027548209367,0.2832244008714597,0.9147889147889149,345,1815,1766,49,280,65,0.8476851851851852,0.5807042759611929,0.5807042759611929
9,0,81,0.5862068965517241,0.8654598825831703,0.19825072886297376,0.9735828288387451,0.2962962962962963,0.9163429163429164,343,1817,1769,48,275,68,0.850462962962963,0.5859167788508595,0.5859167788508595
9,0,82,0.5932203389830508,0.866307541625857,0.20408163265306123,0.9735828288387451,0.3036876355748373,0.9168178284529671,343,1817,1769,48,273,70,0.8513888888888889,0.5888322307459032,0.5888322307459032
9,0,83,0.5847457627118644,0.8658178256611165,0.20116618075801748,0.973032471106219,0.299349240780911,0.9162995594713657,343,1817,1768,49,274,69,0.850462962962963,0.5870993259321182,0.5870993259321182
9,0,84,0.5963302752293578,0.863481228668942,0.18840579710144928,0.9757575757575757,0.28634361233480177,0.916192446973616,345,1815,1771,44,280,65,0.85,0.5820816864295125,0.5820816864295124
9,0,85,0.5892857142857143,0.85791015625,0.18487394957983194,0.9744869661674986,0.2814498933901919,0.9124902622695404,357,1803,1757,46,291,66,0.8439814814814814,0.5796804578736653,0.5796804578736653
9,0,86,0.5491803278688525,0.8675171736997056,0.19881305637982197,0.9698299506308283,0.2919389978213508,0.9158249158249159,337,1823,1768,55,270,67,0.8495370370370371,0.5843215035053252,0.5843215035053252
9,0,87,0.5446428571428571,0.86376953125,0.17941176470588235,0.971978021978022,0.26991150442477874,0.9146845915201653,340,1820,1769,51,279,61,0.8472222222222222,0.5756948933419522,0.5756948933419521
9,0,88,0.5526315789473685,0.8655913978494624,0.1863905325443787,0.9720087815587267,0.27876106194690264,0.9157187176835574,338,1822,1771,51,275,63,0.8490740740740741,0.5791996570515527,0.5791996570515527
9,0,89,0.6,0.8598540145985402,0.1794871794871795,0.9767827529021559,0.2763157894736842,0.9145962732919255,351,1809,1767,42,288,63,0.8472222222222222,0.5781349661946678,0.5781349661946676
9,0,90,0.6296296296296297,0.868421052631579,0.20118343195266272,0.9780461031833151,0.30493273542600896,0.919979349509551,338,1822,1782,40,270,68,0.8564814814814815,0.5896147675679888,0.5896147675679889
9,0,91,0.6216216216216216,0.8633479746217667,0.1977077363896848,0.9768083931529542,0.3,0.916580310880829,349,1811,1769,42,280,69,0.850925925925926,0.5872580647713196,0.5872580647713195
9,0,92,0.6173913043478261,0.8655256723716381,0.20520231213872833,0.9757442116868799,0.3080260303687636,0.9173360974345686,346,1814,1770,44,275,71,0.8523148148148149,0.5904732619128041,0.5904732619128041
9,0,93,0.6330275229357798,0.8703071672354948,0.20597014925373133,0.9780821917808219,0.3108108108108108,0.9210526315789473,335,1825,1785,40,266,69,0.8583333333333333,0.5920261705172766,0.5920261705172767
9,0,94,0.5966386554621849,0.8633023027927487,0.20285714285714285,0.9734806629834254,0.30277185501066095,0.915086990392106,350,1810,1762,48,279,71,0.8486111111111111,0.5881689029202841,0.5881689029202841
9,0,95,0.5688073394495413,0.8615309605070697,0.1791907514450867,0.974090407938258,0.27252747252747256,0.9143596377749029,346,1814,1767,47,284,62,0.8467592592592592,0.5766405796916724,0.5766405796916723
9,0,96,0.5867768595041323,0.8646395291809711,0.20461095100864554,0.9724214009928296,0.3034188034188034,0.9153686396677051,347,1813,1763,50,276,71,0.8490740740740741,0.5885161760007376,0.5885161760007376
9,0,97,0.5636363636363636,0.8702439024390244,0.18902439024390244,0.9737991266375546,0.2831050228310502,0.9191138588356517,328,1832,1784,48,266,62,0.8546296296296296,0.5814117584407286,0.5814117584407286
9,0,98,0.6106194690265486,0.8680996580361504,0.20353982300884957,0.9758374519494784,0.30530973451327437,0.9188210961737331,339,1821,1777,44,270,69,0.8546296296296296,0.589688637479164,0.5896886374791639
9,0,99,0.6068376068376068,0.8614782183064121,0.20056497175141244,0.9745293466223699,0.3014861995753716,0.9145232527929333,354,1806,1760,46,283,71,0.8476851851851852,0.5875471591868912,0.5875471591868912
11,0,0,0.67,0.8660194174757282,0.19533527696793002,0.9818381948266374,0.3024830699774266,0.9202992004126903,343,1817,1784,33,276,67,0.8569444444444444,0.5885867358972837,0.5885867358972837
11,0,1,0.6391752577319587,0.8628211342704799,0.17971014492753623,0.9807162534435262,0.28054298642533937,0.9179989685404847,345,1815,1780,35,283,62,0.8527777777777777,0.5802131991855312,0.5802131991855313
11,0,2,0.65,0.8660194174757282,0.1906158357771261,0.9807586586036283,0.29478458049886624,0.919824697086878,341,1819,1784,35,276,65,0.8560185185185185,0.5856872471903772,0.5856872471903772
11,0,3,0.6923076923076923,0.8593523441275979,0.17796610169491525,0.9844961240310077,0.28314606741573034,0.9176774193548387,354,1806,1778,28,291,63,0.8523148148148149,0.5812311128629615,0.5812311128629615
11,0,4,0.625,0.8667315175097277,0.19174041297935104,0.9785831960461285,0.29345372460496616,0.9192674748516895,339,1821,1782,39,274,65,0.8550925925925926,0.5851618045127398,0.5851618045127398
11,0,5,0.6421052631578947,0.862953995157385,0.17732558139534885,0.9812775330396476,0.27790432801822323,0.9183200206132441,344,1816,1782,34,283,61,0.8532407407407407,0.5793015572174982,0.5793015572174982
11,0,6,0.574468085106383,0.8649564375605033,0.16216216216216217,0.9781061850027367,0.2529274004683841,0.9180580529154894,333,1827,1787,40,279,54,0.8523148148148149,0.5701341735824496,0.5701341735824494
11,0,7,0.6703296703296703,0.8641855969067183,0.1783625730994152,0.9834983498349835,0.28175519630484985,0.9199897092873681,342,1818,1788,30,281,61,0.8560185185185185,0.5809304614671993,0.5809304614671994
11,0,8,0.6132075471698113,0.8646543330087634,0.18950437317784258,0.9774353329664281,0.28953229398663705,0.917592353397055,343,1817,1776,41,278,65,0.8523148148148149,0.5834698530721354,0.5834698530721353
11,0,9,0.648936170212766,0.8664085188770572,0.18100890207715134,0.981897970378497,0.2830626450116009,0.9205451272820776,337,1823,1790,33,276,61,0.8569444444444444,0.5814534362278242,0.5814534362278242
11,0,10,0.6702127659574468,0.8606001936108422,0.1794871794871795,0.9828634604754007,0.28314606741573034,0.9176774193548387,351,1809,1778,31,288,63,0.8523148148148149,0.5811753199812901,0.5811753199812901
11,0,11,0.6853932584269663,0.8652824722356349,0.17941176470588235,0.9846153846153847,0.28438228438228436,0.921099974299666,340,1820,1792,28,279,61,0.8578703703703704,0.5820135746606335,0.5820135746606335
11,0,12,0.6210526315789474,0.8682808716707022,0.1782477341389728,0.9803171131765992,0.27699530516431925,0.92090395480226,331,1829,1793,36,272,59,0.8574074074074074,0.5792824236577859,0.579282423657786
11,0,13,0.6206896551724138,0.8610709117221418,0.15789473684210525,0.9818481848184818,0.2517482517482518,0.9175019275250577,342,1818,1785,33,288,54,0.8513888888888889,0.5698714608302936,0.5698714608302935
11,0,14,0.6630434782608695,0.8650870406189555,0.17941176470588235,0.9829670329670329,0.2824074074074074,0.9202674897119342,340,1820,1789,31,279,61,0.8564814814814815,0.5811893988364577,0.5811893988364576
11,0,15,0.648936170212766,0.8644724104549855,0.17888563049853373,0.9818581638262782,0.28045977011494255,0.9194337194337194,341,1819,1786,33,280,61,0.8550925925925926,0.580371897162406,0.5803718971624059
11,0,16,0.6808510638297872,0.8620522749273959,0.1833810888252149,0.9834345665378245,0.2889390519187359,0.918751612071189,349,1811,1781,30,285,64,0.8541666666666666,0.5834078276815197,0.5834078276815197
11,0,17,0.6235294117647059,0.8621686746987952,0.15634218289085547,0.9824272377814388,0.25000000000000006,0.9183778234086243,339,1821,1789,32,286,53,0.8527777777777777,0.5693847103361471,0.5693847103361471
11,0,18,0.5922330097087378,0.8653378706854643,0.1804733727810651,0.9769484083424808,0.2766439909297052,0.9177623098736788,338,1822,1780,42,277,61,0.8523148148148149,0.5787108905617729,0.5787108905617729
11,0,19,0.6875,0.8638565891472868,0.19020172910662825,0.9834528405956977,0.29796839729119634,0.9197833376321899,347,1813,1783,30,281,66,0.8560185185185185,0.586827284851163,0.586827284851163
11,0,20,0.7045454545454546,0.8624517374517374,0.1786743515850144,0.9856591285162714,0.2850574712643678,0.9199485199485199,347,1813,1787,26,285,62,0.8560185185185185,0.582166740050643,0.582166740050643
11,0,21,0.6888888888888889,0.8589371980676328,0.1751412429378531,0.9844961240310077,0.27927927927927926,0.9174406604747162,354,1806,1778,28,292,62,0.8518518518518519,0.5798186834844304,0.5798186834844304
11,0,22,0.6018518518518519,0.8674463937621832,0.19287833827893175,0.9764125068568295,0.29213483146067415,0.9187096774193548,337,1823,1780,43,272,65,0.8541666666666666,0.5846454225678807,0.5846454225678805
11,0,23,0.7045454545454546,0.86003861003861,0.17613636363636365,0.9856194690265486,0.28181818181818186,0.9185567010309278,352,1808,1782,26,290,62,0.8537037037037037,0.5808779163314561,0.5808779163314561
11,0,24,0.6391752577319587,0.8691226369365003,0.18674698795180722,0.9808533916849015,0.289044289044289,0.9216139809817527,332,1828,1793,35,270,62,0.8587962962962963,0.5838001898183545,0.5838001898183544
11,0,25,0.6494845360824743,0.8642753271934076,0.1836734693877551,0.9812878370941112,0.2863636363636364,0.9190721649484536,343,1817,1783,34,280,63,0.8546296296296296,0.5824806532409331,0.5824806532409331
11,0,26,0.6896551724137931,0.8610709117221418,0.1724137931034483,0.9850993377483444,0.27586206896551724,0.9189189189189189,348,1812,1785,27,288,60,0.8541666666666666,0.5787565654258964,0.5787565654258964
11,0,27,0.6213592233009708,0.8638794360719494,0.18604651162790697,0.9785242290748899,0.28635346756152125,0.9176349083397882,344,1816,1777,39,280,64,0.8523148148148149,0.5822853703513984,0.5822853703513984
11,0,28,0.6285714285714286,0.8666666666666667,0.19411764705882353,0.9785714285714285,0.2966292134831461,0.9192258064516129,340,1820,1781,39,274,66,0.8550925925925926,0.586344537815126,0.586344537815126
11,0,29,0.6391752577319587,0.8652447891420262,0.18235294117647058,0.9807692307692307,0.2837528604118993,0.9193922225083697,340,1820,1785,35,278,62,0.8550925925925926,0.5815610859728506,0.5815610859728506
11,0,30,0.5769230769230769,0.8628404669260701,0.17543859649122806,0.9757975797579758,0.26905829596412556,0.9158492514197212,342,1818,1774,44,282,60,0.8490740740740741,0.5756180881246019,0.5756180881246019
11,0,31,0.6296296296296297,0.8596491228070176,0.19101123595505617,0.9778270509977827,0.29310344827586204,0.9149377593360996,356,1804,1764,40,288,68,0.8481481481481481,0.5844191434764194,0.5844191434764194
11,0,32,0.6781609195402298,0.8649300530631935,0.17404129793510326,0.9846238330587589,0.27699530516431925,0.92090395480226,339,1821,1793,28,280,59,0.8574074074074074,0.579332565496931,0.5793325654969311
11,0,33,0.6741573033707865,0.8638338966682761,0.17543859649122806,0.9840484048404841,0.27842227378190254,0.9200308562612497,342,1818,1789,29,282,60,0.8560185185185185,0.5797435006658561,0.579743500665856
11,0,34,0.6774193548387096,0.8626028059990324,0.18155619596541786,0.9834528405956977,0.2863636363636364,0.9190721649484537,347,1813,1783,30,284,63,0.8546296296296296,0.5825045182805578,0.5825045182805578
11,0,35,0.6464646464646465,0.8670548277535177,0.1893491124260355,0.9807903402854007,0.2929061784897025,0.920422353850116,338,1822,1787,35,274,64,0.8569444444444444,0.5850697263557182,0.5850697263557181
11,0,36,0.6568627450980392,0.8658892128279884,0.19533527696793002,0.9807374793615851,0.30112359550561796,0.919741935483871,343,1817,1782,35,276,67,0.8560185185185185,0.5880363781647575,0.5880363781647575
11,0,37,0.66,0.8621359223300971,0.18857142857142858,0.9812154696132597,0.29333333333333333,0.9178294573643412,350,1810,1776,34,284,66,0.8527777777777777,0.5848934490923441,0.5848934490923441
11,0,38,0.6373626373626373,0.8627356210729821,0.1695906432748538,0.9818481848184818,0.2678983833718245,0.9184461023925906,342,1818,1785,33,284,58,0.8532407407407407,0.5757194140466678,0.5757194140466678
11,0,39,0.6703296703296703,0.8646689221846302,0.17888563049853373,0.9835074216602528,0.28240740740740744,0.9202674897119342,341,1819,1789,30,280,61,0.8564814814814815,0.5811965260793933,0.5811965260793932
11,0,40,0.6391752577319587,0.8642753271934076,0.18128654970760233,0.9807480748074807,0.2824601366742596,0.9188353517134757,342,1818,1783,35,280,62,0.8541666666666666,0.5810173122575415,0.5810173122575416
11,0,41,0.6813186813186813,0.8670855485741904,0.18397626112759644,0.984092155787164,0.2897196261682243,0.9218910585817061,337,1823,1794,29,275,62,0.8592592592592593,0.5840342084573802,0.5840342084573802
11,0,42,0.6534653465346535,0.861583292860612,0.18803418803418803,0.9806522940851299,0.2920353982300885,0.9172699069286453,351,1809,1774,35,285,66,0.8518518518518519,0.584343241059659,0.584343241059659
11,0,43,0.6090909090909091,0.8653658536585366,0.19533527696793002,0.9763346175013758,0.2958057395143488,0.9175071114559089,343,1817,1774,43,276,67,0.8523148148148149,0.5858349472346529,0.5858349472346529
11,0,44,0.7096774193548387,0.8645379777455249,0.1907514450867052,0.9851157662624035,0.30068337129840544,0.9208966761144035,346,1814,1787,27,280,66,0.8578703703703704,0.5879336056745543,0.5879336056745543
11,0,45,0.6363636363636364,0.8597768073750607,0.17897727272727273,0.9800884955752213,0.27937915742793795,0.9159989661411219,352,1808,1772,36,289,63,0.8495370370370371,0.579532884151247,0.5795328841512469
11,0,46,0.6847826086956522,0.8650870406189555,0.18421052631578946,0.9840484048404841,0.29032258064516125,0.9207411219763253,342,1818,1789,29,279,63,0.8574074074074074,0.5841294655781367,0.5841294655781368
11,0,47,0.6666666666666666,0.8638565891472868,0.1855072463768116,0.9823691460055096,0.29024943310657597,0.9193091002835783,345,1815,1783,32,281,64,0.8550925925925926,0.5839381961911607,0.5839381961911606
11,0,48,0.6190476190476191,0.8725060827250608,0.19877675840978593,0.9781778505182761,0.30092592592592593,0.9223251028806585,327,1833,1793,40,262,65,0.8601851851851852,0.588477304464031,0.588477304464031
11,0,49,0.67,0.8660194174757282,0.19533527696793002,0.9818381948266374,0.3024830699774266,0.9202992004126903,343,1817,1784,33,276,67,0.8569444444444444,0.5885867358972837,0.5885867358972837
11,0,50,0.6372549019607843,0.8620019436345967,0.18624641833810887,0.9795692987299834,0.2882483370288248,0.9170328250193849,349,1811,1774,37,284,65,0.8513888888888889,0.5829078585340461,0.5829078585340461
11,0,51,0.6428571428571429,0.8680892337536372,0.1880597014925373,0.9808219178082191,0.29099307159353355,0.9210187805505531,335,1825,1790,35,272,63,0.8578703703703704,0.5844408096503783,0.5844408096503783
11,0,52,0.6666666666666666,0.8626028059990324,0.1791907514450867,0.9829106945975744,0.2824601366742597,0.918835351713476,346,1814,1783,31,284,62,0.8541666666666666,0.5810507230213307,0.5810507230213305
11,0,53,0.6458333333333334,0.8662790697674418,0.1834319526627219,0.9813391877058177,0.28571428571428575,0.9202264539372105,338,1822,1788,34,276,62,0.8564814814814815,0.5823855701842698,0.5823855701842698
11,0,54,0.6458333333333334,0.8619186046511628,0.1786743515850144,0.9812465526751241,0.2799097065462754,0.9177198865101883,347,1813,1779,34,285,62,0.8523148148148149,0.5799604521300692,0.5799604521300692
11,0,55,0.6881720430107527,0.8635703918722787,0.18497109826589594,0.984013230429989,0.2915717539863325,0.9198660139139397,346,1814,1785,29,282,64,0.8560185185185185,0.5844921643479425,0.5844921643479425
11,0,56,0.6630434782608695,0.8621856866537717,0.17630057803468208,0.9829106945975744,0.2785388127853881,0.9185986604842864,346,1814,1783,31,285,61,0.8537037037037037,0.5796056363161283,0.5796056363161283
11,0,57,0.6630434782608695,0.8617021276595744,0.17579250720461095,0.9829012686155544,0.27790432801822323,0.9183200206132439,347,1813,1782,31,286,61,0.8532407407407407,0.5793468879100826,0.5793468879100826
11,0,58,0.6326530612244898,0.8622696411251213,0.1791907514450867,0.980154355016538,0.2792792792792793,0.9174406604747163,346,1814,1778,36,284,62,0.8518518518518519,0.5796725532308125,0.5796725532308123
11,0,59,0.673469387755102,0.8632395732298739,0.1896551724137931,0.9823399558498896,0.29596412556053814,0.9189468249870935,348,1812,1780,32,282,66,0.8546296296296296,0.5859975641318415,0.5859975641318413
11,0,60,0.6590909090909091,0.8653474903474904,0.17210682492581603,0.9835436094349973,0.27294117647058824,0.9206675224646984,337,1823,1793,30,279,58,0.8569444444444444,0.5778252171804067,0.5778252171804066
11,0,61,0.632183908045977,0.8634828750602991,0.16272189349112426,0.9824368825466521,0.2588235294117647,0.9191270860077022,338,1822,1790,32,283,55,0.8541666666666666,0.5725793880188882,0.5725793880188882
11,0,62,0.6593406593406593,0.861285645239246,0.1729106628242075,0.9829012686155544,0.273972602739726,0.9180834621329211,347,1813,1782,31,287,60,0.8527777777777777,0.577905965719881,0.577905965719881
11,0,63,0.7142857142857143,0.8598356694055099,0.18309859154929578,0.9855955678670361,0.2914798206278027,0.9184305627258647,355,1805,1779,26,290,65,0.8537037037037037,0.5843470797081659,0.5843470797081659
11,0,64,0.6021505376344086,0.8587324625060474,0.16091954022988506,0.9795805739514348,0.25396825396825395,0.9151843258571797,348,1812,1775,37,292,56,0.8476851851851852,0.5702500570906599,0.5702500570906599
11,0,65,0.7108433734939759,0.862782859894078,0.17151162790697674,0.986784140969163,0.2763466042154567,0.920626765990239,344,1816,1792,24,285,59,0.8569444444444444,0.5791478844380699,0.5791478844380699
11,0,66,0.6504854368932039,0.8643655809431211,0.1936416184971098,0.980154355016538,0.2984409799554566,0.918625678119349,346,1814,1778,36,279,67,0.8541666666666666,0.586897986756824,0.5868979867568239
11,0,67,0.63,0.866504854368932,0.1863905325443787,0.9796926454445664,0.2876712328767123,0.919629057187017,338,1822,1785,37,275,63,0.8555555555555555,0.5830415889944726,0.5830415889944724
11,0,68,0.5918367346938775,0.8637245392822502,0.1710914454277286,0.9780340472267984,0.26544622425629294,0.9173319598248777,339,1821,1781,40,281,58,0.8513888888888889,0.5745627463272636,0.5745627463272636
11,0,69,0.6185567010309279,0.8671837130392632,0.17964071856287425,0.97973713033954,0.27842227378190254,0.9200308562612497,334,1826,1789,37,274,60,0.8560185185185185,0.5796889244512071,0.5796889244512071
11,0,70,0.6836734693877551,0.8622696411251213,0.1908831908831909,0.9828634604754007,0.29844097995545654,0.9186256781193491,351,1809,1778,31,284,67,0.8541666666666666,0.5868733256792958,0.5868733256792957
11,0,71,0.6326530612244898,0.8593598448108632,0.17613636363636365,0.9800884955752213,0.27555555555555555,0.9157622739018088,352,1808,1772,36,290,62,0.8490740740740741,0.5781124296057926,0.5781124296057925
11,0,72,0.6326530612244898,0.8632395732298739,0.18023255813953487,0.9801762114537445,0.28054298642533937,0.9179989685404848,344,1816,1780,36,282,62,0.8527777777777777,0.5802043847966396,0.5802043847966396
11,0,73,0.6237623762376238,0.861583292860612,0.1810344827586207,0.9790286975717439,0.2806236080178174,0.916559028674761,348,1812,1774,38,285,63,0.850462962962963,0.5800315901651824,0.5800315901651822
11,0,74,0.6634615384615384,0.8672178988326849,0.20175438596491227,0.9807480748074807,0.3094170403587444,0.9204956117707795,342,1818,1783,35,273,69,0.8574074074074074,0.5912512303861965,0.5912512303861965
11,0,75,0.6421052631578947,0.8600484261501211,0.1742857142857143,0.9812154696132597,0.27415730337078653,0.9166451612903226,350,1810,1776,34,289,61,0.850462962962963,0.577750591949487,0.577750591949487
11,0,76,0.6019417475728155,0.8682547399124939,0.18618618618618618,0.9775588396278051,0.2844036697247706,0.9196704428424305,333,1827,1786,41,271,62,0.8555555555555555,0.5818725129069956,0.5818725129069957
11,0,77,0.696969696969697,0.8675400291120815,0.20175438596491227,0.9834983498349835,0.3129251700680272,0.9218870843000773,342,1818,1788,30,273,69,0.8597222222222223,0.5926263678999478,0.5926263678999479
11,0,78,0.5876288659793815,0.868637905962191,0.17378048780487804,0.9781659388646288,0.26823529411764707,0.9201540436456996,328,1832,1792,40,271,57,0.8560185185185185,0.5759732133347534,0.5759732133347535
11,0,79,0.6382978723404256,0.8649564375605033,0.17699115044247787,0.9813289401427787,0.27713625866050806,0.9194751736557757,339,1821,1787,34,279,60,0.8550925925925926,0.5791600452926283,0.5791600452926283
11,0,80,0.6630434782608695,0.8612185686653772,0.1752873563218391,0.9828918322295805,0.2772727272727273,0.918041237113402,348,1812,1781,31,287,61,0.8527777777777777,0.5790895942757098,0.5790895942757098
11,0,81,0.6770833333333334,0.8614341085271318,0.18518518518518517,0.9828634604754007,0.29082774049217,0.9181513038987864,351,1809,1778,31,286,65,0.8532407407407407,0.5840243228302929,0.584024322830293
11,0,82,0.6777777777777778,0.8603864734299517,0.1742857142857143,0.9839779005524862,0.2772727272727273,0.918041237113402,350,1810,1781,29,289,61,0.8527777777777777,0.5791318074191003,0.5791318074191003
11,0,83,0.6262626262626263,0.8680252304706453,0.18562874251497005,0.97973713033954,0.28637413394919164,0.9205042449189607,334,1826,1789,37,272,62,0.8569444444444444,0.582682936427255,0.582682936427255
11,0,84,0.6336633663366337,0.8688683827100534,0.19161676646706588,0.97973713033954,0.2942528735632184,0.9209781209781209,334,1826,1789,37,270,64,0.8578703703703704,0.585676948403303,0.585676948403303
11,0,85,0.6526315789473685,0.8624697336561743,0.1791907514450867,0.9818081587651599,0.2811791383219955,0.9182779066769787,346,1814,1781,33,284,62,0.8532407407407407,0.5804994551051234,0.5804994551051232
11,0,86,0.648936170212766,0.8596321393998064,0.1737891737891738,0.9817578772802653,0.27415730337078653,0.9166451612903227,351,1809,1776,33,290,61,0.850462962962963,0.5777735255347196,0.5777735255347196
11,0,87,0.6777777777777778,0.8647342995169082,0.17888563049853373,0.9840571742715778,0.28306264501160094,0.9205451272820776,341,1819,1790,29,280,61,0.8569444444444444,0.5814714023850558,0.5814714023850558
11,0,88,0.65625,0.8662790697674418,0.18584070796460178,0.9818780889621087,0.28965517241379307,0.9204633204633205,339,1821,1788,33,276,63,0.8569444444444444,0.5838593984633552,0.5838593984633552
11,0,89,0.6526315789473685,0.8639225181598063,0.18075801749271136,0.9818381948266374,0.2831050228310502,0.9191138588356518,343,1817,1784,33,281,62,0.8546296296296296,0.5812981061596743,0.5812981061596744
11,0,90,0.6262626262626263,0.8602620087336245,0.17714285714285713,0.9795580110497237,0.27616926503340755,0.916042366313614,350,1810,1773,37,288,62,0.8495370370370371,0.5783504340962904,0.5783504340962904
11,0,91,0.6881720430107527,0.8640541848089018,0.1855072463768116,0.9840220385674932,0.29223744292237447,0.9201442555383824,345,1815,1786,29,281,64,0.8564814814814815,0.5847646424721524,0.5847646424721524
11,0,92,0.5851063829787234,0.856727976766699,0.15669515669515668,0.978441127694859,0.24719101123595505,0.9135483870967741,351,1809,1770,39,296,55,0.8449074074074074,0.5675681421950078,0.5675681421950078
11,0,93,0.6513761467889908,0.8683568990736226,0.20821114369501467,0.9791094007696537,0.31555555555555553,0.9204134366925064,341,1819,1781,38,270,71,0.8574074074074074,0.5936602722323342,0.5936602722323342
11,0,94,0.6326530612244898,0.8661493695441319,0.1834319526627219,0.9802414928649835,0.2844036697247706,0.9196704428424305,338,1822,1786,36,276,62,0.8555555555555555,0.5818367227638528,0.5818367227638528
11,0,95,0.6057692307692307,0.8633268482490273,0.18313953488372092,0.9774229074889867,0.28125,0.9168388429752066,344,1816,1775,41,281,63,0.850925925925926,0.5802812211863538,0.5802812211863538
11,0,96,0.6372549019607843,0.8639455782312925,0.18840579710144928,0.9796143250688705,0.29082774049217003,0.9181513038987863,345,1815,1778,37,280,65,0.8532407407407407,0.5840100610851598,0.5840100610851598
11,0,97,0.6391752577319587,0.8652447891420262,0.18235294117647058,0.9807692307692307,0.2837528604118993,0.9193922225083697,340,1820,1785,35,278,62,0.8550925925925926,0.5815610859728506,0.5815610859728506
11,0,98,0.6442307692307693,0.8706225680933852,0.2012012012012012,0.9797482211275315,0.3066361556064073,0.921967550862735,333,1827,1790,37,266,67,0.8597222222222223,0.5904747111643663,0.5904747111643663
11,0,99,0.6666666666666666,0.8662790697674418,0.18823529411764706,0.9824175824175824,0.29357798165137616,0.9207003089598352,340,1820,1788,32,276,64,0.8574074074074074,0.5853264382676148,0.5853264382676148
13,0,0,0.651685393258427,0.8619024625784645,0.1686046511627907,0.9829295154185022,0.2678983833718245,0.9184461023925906,344,1816,1785,31,286,58,0.8532407407407407,0.5757670832906464,0.5757670832906464
13,0,1,0.6666666666666666,0.8620356970574047,0.1686046511627907,0.9840308370044053,0.2691415313225058,0.9190023142195938,344,1816,1787,29,286,58,0.8541666666666666,0.576317744083598,0.5763177440835979
13,0,2,0.6506024096385542,0.8579682233991334,0.15472779369627507,0.9839867476532302,0.25,0.9166666666666666,349,1811,1782,29,295,54,0.85,0.5693572706747526,0.5693572706747527
13,0,3,0.6753246753246753,0.8602976476236198,0.15160349854227406,0.9862410566868465,0.24761904761904763,0.9189743589743591,343,1817,1792,25,291,52,0.8537037037037037,0.5689222776145603,0.5689222776145603
13,0,4,0.675,0.8605769230769231,0.1569767441860465,0.98568281938326,0.25471698113207547,0.9188911704312116,344,1816,1790,26,290,54,0.8537037037037037,0.5713297817846532,0.5713297817846532
13,0,5,0.6341463414634146,0.8638113570741097,0.15522388059701492,0.9835616438356164,0.24940047961630696,0.9198052779912887,335,1825,1795,30,283,52,0.8550925925925926,0.5693927622163157,0.5693927622163157
13,0,6,0.7361111111111112,0.860632183908046,0.15406976744186046,0.9895374449339207,0.2548076923076923,0.9205942622950819,344,1816,1797,19,291,53,0.8564814814814815,0.5718036061878906,0.5718036061878906
13,0,7,0.7023809523809523,0.8607899807321773,0.16954022988505746,0.9862030905077263,0.27314814814814814,0.919238683127572,348,1812,1787,25,289,59,0.8546296296296296,0.5778716601963918,0.5778716601963919
13,0,8,0.6630434782608695,0.8592843326885881,0.17329545454545456,0.9828539823008849,0.27477477477477474,0.9169246646026832,352,1808,1777,31,291,61,0.850925925925926,0.5780747184231697,0.5780747184231698
13,0,9,0.632183908045977,0.8596237337192475,0.15895953757225434,0.9823594266813671,0.2540415704387991,0.9169024954978133,346,1814,1782,32,291,55,0.850462962962963,0.5706594821268107,0.5706594821268107
13,0,10,0.6585365853658537,0.8633301251203079,0.15976331360946747,0.9846322722283205,0.2571428571428572,0.9199999999999998,338,1822,1794,28,284,54,0.8555555555555555,0.5721977929188939,0.5721977929188939
13,0,11,0.6,0.8567307692307692,0.13872832369942195,0.9823594266813671,0.2253521126760563,0.9152542372881355,346,1814,1782,32,298,48,0.8472222222222222,0.5605438751903945,0.5605438751903945
13,0,12,0.6627906976744186,0.8674059787849566,0.1716867469879518,0.9841356673960613,0.2727272727272727,0.9220912352639672,332,1828,1799,29,275,57,0.8592592592592593,0.5779112071920065,0.5779112071920065
13,0,13,0.6829268292682927,0.8589990375360924,0.16045845272206305,0.9856432909994478,0.2598607888631091,0.9179737721779377,349,1811,1785,26,293,56,0.8523148148148149,0.5730508718607555,0.5730508718607554
13,0,14,0.6707317073170732,0.8609239653512993,0.15988372093023256,0.9851321585903083,0.2582159624413146,0.9188495120698511,344,1816,1789,27,289,55,0.8537037037037037,0.5725079397602705,0.5725079397602704
13,0,15,0.7073170731707317,0.8604427333974976,0.16666666666666666,0.9867549668874173,0.26976744186046514,0.9192802056555269,348,1812,1788,24,290,58,0.8546296296296296,0.5767108167770421,0.576710816777042
13,0,16,0.6588235294117647,0.8597590361445783,0.16138328530259366,0.9840044125758411,0.25925925925925924,0.9176954732510287,347,1813,1784,29,291,56,0.8518518518518519,0.5726938489392174,0.5726938489392174
13,0,17,0.5952380952380952,0.8622350674373795,0.1488095238095238,0.981359649122807,0.23809523809523808,0.9179487179487179,336,1824,1790,34,286,50,0.8518518518518519,0.5650845864661654,0.5650845864661654
13,0,18,0.6162790697674418,0.8645130183220829,0.15868263473053892,0.9819277108433735,0.2523809523809524,0.9194871794871795,334,1826,1793,33,281,53,0.8546296296296296,0.5703051727869562,0.5703051727869562
13,0,19,0.717948717948718,0.8597502401536984,0.16091954022988506,0.9878587196467992,0.26291079812206575,0.9193631227529534,348,1812,1790,22,292,56,0.8546296296296296,0.5743891299383421,0.5743891299383421
13,0,20,0.7183098591549296,0.8611775969363332,0.1495601173020528,0.9890049477735019,0.2475728155339806,0.920675537359263,341,1819,1799,20,290,51,0.8564814814814815,0.5692825325377774,0.5692825325377773
13,0,21,0.625,0.8572115384615384,0.1440922190201729,0.9834528405956977,0.234192037470726,0.9160030824556896,347,1813,1783,30,297,50,0.8486111111111111,0.5637725298079352,0.5637725298079352
13,0,22,0.6341463414634146,0.8556304138594802,0.14772727272727273,0.9834070796460177,0.23963133640552997,0.9150797735460627,352,1808,1778,30,300,52,0.8472222222222222,0.5655671761866452,0.5655671761866452
13,0,23,0.6962025316455697,0.8582412301777992,0.15714285714285714,0.9867403314917127,0.2564102564102564,0.9180159342071447,350,1810,1786,24,295,55,0.8523148148148149,0.5719415943172849,0.571941594317285
13,0,24,0.6585365853658537,0.8589990375360924,0.15561959654178675,0.9845559845559846,0.2517482517482518,0.917501927525058,347,1813,1785,28,293,54,0.8513888888888889,0.5700877905488857,0.5700877905488857
13,0,25,0.618421052631579,0.8627639155470249,0.14114114114114115,0.9841269841269841,0.22982885085574573,0.9194579391459985,333,1827,1798,29,286,47,0.8541666666666666,0.5626340626340627,0.5626340626340627
13,0,26,0.6081081081081081,0.8600191754554171,0.13353115727002968,0.984092155787164,0.218978102189781,0.9178818112049117,337,1823,1794,29,292,45,0.8513888888888889,0.5588116565285969,0.5588116565285968
13,0,27,0.6794871794871795,0.8640730067243035,0.15773809523809523,0.9862938596491229,0.2560386473429952,0.9211469534050178,336,1824,1799,25,283,53,0.8574074074074074,0.5720159774436091,0.572015977443609
13,0,28,0.7215189873417721,0.8644882268140317,0.168141592920354,0.9879187259747392,0.27272727272727276,0.9220912352639672,339,1821,1799,22,282,57,0.8592592592592593,0.5780301594475465,0.5780301594475465
13,0,29,0.651685393258427,0.8541767262192178,0.16111111111111112,0.9827777777777778,0.2583518930957684,0.913975716869026,360,1800,1769,31,302,58,0.8458333333333333,0.5719444444444445,0.5719444444444444
13,0,30,0.6794871794871795,0.8621517771373679,0.15588235294117647,0.9862637362637363,0.2535885167464115,0.920041004613019,340,1820,1795,25,287,53,0.8555555555555555,0.5710730446024563,0.5710730446024563
13,0,31,0.6744186046511628,0.8635486981677917,0.17008797653958943,0.9846069268829027,0.2716627634660421,0.9201130233752889,341,1819,1791,28,283,58,0.8560185185185185,0.5773474517112461,0.577347451711246
13,0,32,0.6329113924050633,0.8596828447861605,0.14619883040935672,0.9840484048404841,0.23752969121140144,0.917671197743011,342,1818,1789,29,292,50,0.8513888888888889,0.5651236176249204,0.5651236176249205
13,0,33,0.6790123456790124,0.8605098605098606,0.15942028985507245,0.9856749311294766,0.25821596244131456,0.918849512069851,345,1815,1789,26,290,55,0.8537037037037037,0.5725476104922745,0.5725476104922745
13,0,34,0.62,0.8694174757281553,0.18731117824773413,0.9792236194641881,0.2877030162412993,0.9210593983029055,331,1829,1791,38,269,62,0.8578703703703704,0.5832673988559611,0.5832673988559611
13,0,35,0.6578947368421053,0.8594049904030711,0.1457725947521866,0.9856906989543203,0.2386634844868735,0.9182260958728531,343,1817,1791,26,293,50,0.8523148148148149,0.5657316468532535,0.5657316468532534
13,0,36,0.7380952380952381,0.8631984585741811,0.1791907514450867,0.9878721058434399,0.28837209302325584,0.9213367609254497,346,1814,1792,22,284,62,0.8583333333333333,0.5835314286442633,0.5835314286442633
13,0,37,0.65,0.8586538461538461,0.15028901734104047,0.9845644983461963,0.24413145539906103,0.9173086800205443,346,1814,1786,28,294,52,0.850925925925926,0.5674267578436184,0.5674267578436184
13,0,38,0.6739130434782609,0.8612185686653772,0.17765042979942694,0.9834345665378245,0.2811791383219955,0.9182779066769786,349,1811,1781,30,287,62,0.8532407407407407,0.5805424981686256,0.5805424981686257
13,0,39,0.6375,0.8620192307692308,0.15088757396449703,0.9840834248079035,0.24401913875598086,0.9190158892875449,338,1822,1793,29,287,51,0.8537037037037037,0.5674854993862003,0.5674854993862003
13,0,40,0.6746987951807228,0.8623013962445836,0.16374269005847952,0.9851485148514851,0.26352941176470585,0.9196405648267009,342,1818,1791,27,286,56,0.8550925925925926,0.5744456024549823,0.5744456024549823
13,0,41,0.6774193548387096,0.8655055636187712,0.18475073313782991,0.9835074216602528,0.2903225806451613,0.9207411219763253,341,1819,1789,30,278,63,0.8574074074074074,0.5841290773990414,0.5841290773990413
13,0,42,0.6419753086419753,0.8619528619528619,0.15339233038348082,0.9840746842394289,0.24761904761904763,0.9189743589743589,339,1821,1792,29,287,52,0.8537037037037037,0.5687335073114549,0.5687335073114549
13,0,43,0.6233766233766234,0.8535765722515603,0.1359773371104816,0.9839513004980631,0.22325581395348842,0.9141388174807198,353,1807,1778,29,305,48,0.8453703703703703,0.5599643188042723,0.5599643188042723
13,0,44,0.7058823529411765,0.8551625239005736,0.13675213675213677,0.9889441680486457,0.22911694510739858,0.9172007177646757,351,1809,1789,20,303,48,0.850462962962963,0.5628481524003912,0.5628481524003912
13,0,45,0.6329113924050633,0.8640076886112446,0.15015015015015015,0.9841269841269841,0.24271844660194178,0.9201637666325486,333,1827,1798,29,283,50,0.8555555555555555,0.5671385671385673,0.5671385671385671
13,0,46,0.6777777777777778,0.8642512077294686,0.1783625730994152,0.9840484048404841,0.2824074074074074,0.9202674897119342,342,1818,1789,29,281,61,0.8564814814814815,0.5812054889699496,0.5812054889699496
13,0,47,0.7160493827160493,0.8561808561808562,0.16246498599439776,0.9872434830837493,0.2648401826484018,0.9170530654301906,357,1803,1780,23,299,58,0.850925925925926,0.5748542345390736,0.5748542345390735
13,0,48,0.647887323943662,0.8549545236955481,0.1318051575931232,0.9861954721148537,0.21904761904761902,0.9158974358974359,349,1811,1786,25,303,46,0.8481481481481481,0.5590003148539885,0.5590003148539884
13,0,49,0.6309523809523809,0.8636801541425819,0.15773809523809523,0.9830043859649122,0.2523809523809524,0.9194871794871795,336,1824,1793,31,283,53,0.8546296296296296,0.5703712406015038,0.5703712406015037
13,0,50,0.6987951807228916,0.8647087144920559,0.1710914454277286,0.9862712795167491,0.27488151658767773,0.9214982042072858,339,1821,1796,25,281,58,0.8583333333333333,0.5786813624722389,0.5786813624722389
13,0,51,0.675,0.8625,0.1588235294117647,0.9857142857142858,0.2571428571428571,0.9200000000000002,340,1820,1794,26,286,54,0.8555555555555555,0.5722689075630252,0.5722689075630252
13,0,52,0.717948717948718,0.861671469740634,0.16279069767441862,0.987885462555066,0.26540284360189575,0.9204720369420216,344,1816,1794,22,288,56,0.8564814814814815,0.5753380801147424,0.5753380801147423
13,0,53,0.7083333333333334,0.8591954022988506,0.14782608695652175,0.9884297520661157,0.2446043165467626,0.9192928516525749,345,1815,1794,21,294,51,0.8541666666666666,0.5681279195113187,0.5681279195113187
13,0,54,0.6707317073170732,0.856111645813282,0.1553672316384181,0.9850498338870431,0.25229357798165136,0.9160659114315138,354,1806,1779,27,299,55,0.8490740740740741,0.5702085327627306,0.5702085327627306
13,0,55,0.6395348837209303,0.8654773384763742,0.16467065868263472,0.9830230010952903,0.2619047619047619,0.9205128205128205,334,1826,1795,31,279,55,0.8564814814814815,0.5738468298889625,0.5738468298889625
13,0,56,0.6777777777777778,0.8594202898550725,0.17329545454545456,0.9839601769911505,0.27601809954751133,0.9174832387828779,352,1808,1779,29,291,61,0.8518518518518519,0.5786278157683026,0.5786278157683025
13,0,57,0.6585365853658537,0.8599615014436959,0.1565217391304348,0.984573002754821,0.2529274004683841,0.9180580529154894,345,1815,1787,28,291,54,0.8523148148148149,0.5705473709426279,0.5705473709426279
13,0,58,0.6623376623376623,0.8588574171867499,0.14782608695652175,0.9856749311294766,0.24170616113744078,0.9179066187788608,345,1815,1789,26,294,51,0.8518518518518519,0.5667505090429992,0.5667505090429992
13,0,59,0.7066666666666667,0.8565947242206235,0.15056818181818182,0.9878318584070797,0.24824355971896955,0.9175443103005394,352,1808,1786,22,299,53,0.8513888888888889,0.5692000201126307,0.5692000201126307
13,0,60,0.6455696202531646,0.8620855358000961,0.15088757396449703,0.9846322722283205,0.2446043165467626,0.9192928516525749,338,1822,1794,28,287,51,0.8541666666666666,0.5677599230964088,0.5677599230964088
13,0,61,0.6136363636363636,0.8595559845559846,0.1565217391304348,0.981267217630854,0.2494226327944573,0.9163879598662207,345,1815,1781,34,291,54,0.8495370370370371,0.5688944783806443,0.5688944783806444
13,0,62,0.6904761904761905,0.8583815028901735,0.16477272727272727,0.9856194690265486,0.2660550458715596,0.917610710607621,352,1808,1782,26,294,58,0.8518518518518519,0.5751960981496379,0.5751960981496379
13,0,63,0.6463414634146342,0.8628488931665063,0.15680473372781065,0.9840834248079035,0.2523809523809524,0.9194871794871795,338,1822,1793,29,285,53,0.8546296296296296,0.570444079267857,0.5704440792678571
13,0,64,0.6626506024096386,0.8637457871930669,0.16272189349112426,0.9846322722283205,0.26128266033254155,0.9202359579379328,338,1822,1794,28,283,55,0.8560185185185185,0.5736770828597224,0.5736770828597224
13,0,65,0.6593406593406593,0.8651522474625423,0.17699115044247787,0.9829763866007688,0.27906976744186046,0.9203084832904883,339,1821,1790,31,279,60,0.8564814814814815,0.5799837685216234,0.5799837685216234
13,0,66,0.6823529411764706,0.8597590361445783,0.166189111747851,0.9850911098840419,0.2672811059907834,0.9181677817807514,349,1811,1784,27,291,58,0.8527777777777777,0.5756401108159466,0.5756401108159465
13,0,67,0.6710526315789473,0.8579654510556622,0.14697406340057637,0.9862107004964148,0.2411347517730496,0.9176289453425712,347,1813,1788,25,296,51,0.8513888888888889,0.5665923819484956,0.5665923819484956
13,0,68,0.6338028169014085,0.8530397319291527,0.1278409090909091,0.9856194690265486,0.2127659574468085,0.9145496535796768,352,1808,1782,26,307,45,0.8458333333333333,0.556730189058729,0.5567301890587288
13,0,69,0.6626506024096386,0.862782859894078,0.16176470588235295,0.9846153846153847,0.2600472813238771,0.9196818065178343,340,1820,1792,28,285,55,0.8550925925925926,0.5731900452488689,0.5731900452488687
13,0,70,0.6973684210526315,0.8598848368522073,0.1536231884057971,0.9873278236914601,0.2517814726840855,0.919210053859964,345,1815,1792,23,292,53,0.8541666666666666,0.5704755060486285,0.5704755060486286
13,0,71,0.6582278481012658,0.8558385391638635,0.14772727272727273,0.985066371681416,0.24129930394431556,0.9159166880946259,352,1808,1781,27,300,52,0.8486111111111111,0.5663968222043443,0.5663968222043443
13,0,72,0.7195121951219512,0.861405197305101,0.17002881844380405,0.9873138444567016,0.27505827505827507,0.9200719609354922,347,1813,1790,23,288,59,0.8560185185185185,0.5786713314502528,0.5786713314502527
13,0,73,0.5888888888888889,0.866183574879227,0.1606060606060606,0.9797814207650273,0.2523809523809524,0.9194871794871794,330,1830,1793,37,277,53,0.8546296296296296,0.570193740685544,0.570193740685544
13,0,74,0.6626506024096386,0.8656716417910447,0.16467065868263472,0.9846659364731654,0.26378896882494,0.9213425570074302,334,1826,1798,28,279,55,0.8578703703703704,0.5746682975779001,0.5746682975779001
13,0,75,0.7126436781609196,0.8639652677279306,0.18023255813953487,0.9862334801762115,0.2877030162412993,0.9210593983029057,344,1816,1791,25,282,62,0.8578703703703704,0.5832330191578731,0.5832330191578732
13,0,76,0.6493506493506493,0.8617378780604896,0.14792899408284024,0.9851811196487377,0.24096385542168677,0.9193341869398207,338,1822,1795,27,288,50,0.8541666666666666,0.566555056865789,0.566555056865789
13,0,77,0.691358024691358,0.8614718614718615,0.16279069767441862,0.9862334801762115,0.2635294117647059,0.919640564826701,344,1816,1791,25,288,56,0.8550925925925926,0.574512088925315,0.574512088925315
13,0,78,0.6585365853658537,0.8604427333974976,0.1569767441860465,0.9845814977973568,0.2535211267605634,0.9183359013867488,344,1816,1788,28,290,54,0.8527777777777777,0.5707791209917017,0.5707791209917017
13,0,79,0.704225352112676,0.8606988989947343,0.1466275659824047,0.9884551951621771,0.24271844660194175,0.9201637666325486,341,1819,1798,21,291,50,0.8555555555555555,0.5675413805722909,0.5675413805722909
13,0,80,0.5842696629213483,0.8599710284886528,0.15204678362573099,0.9796479647964796,0.24129930394431554,0.9159166880946258,342,1818,1781,37,290,52,0.8486111111111111,0.5658473742111052,0.5658473742111053
13,0,81,0.7297297297297297,0.8590604026845637,0.15517241379310345,0.9889624724061811,0.2559241706161138,0.9194458696767573,348,1812,1792,20,294,54,0.8546296296296296,0.5720674430996422,0.5720674430996422
13,0,82,0.632183908045977,0.8596237337192475,0.15895953757225434,0.9823594266813671,0.2540415704387991,0.9169024954978133,346,1814,1782,32,291,55,0.850462962962963,0.5706594821268107,0.5706594821268107
13,0,83,0.7142857142857143,0.8598175708113298,0.1585014409221902,0.987865416436845,0.25943396226415094,0.9194045174537988,347,1813,1791,22,292,55,0.8546296296296296,0.5731834286795175,0.5731834286795177
13,0,84,0.7108433734939759,0.8637457871930669,0.17251461988304093,0.9867986798679867,0.2776470588235294,0.9211810012836971,342,1818,1794,24,283,59,0.8578703703703704,0.5796566498755139,0.5796566498755138
13,0,85,0.7023809523809523,0.8631984585741811,0.17201166180758018,0.9862410566868465,0.27634660421545665,0.920626765990239,343,1817,1792,25,284,59,0.8569444444444444,0.5791263592472133,0.5791263592472133
13,0,86,0.675,0.8629807692307693,0.1592920353982301,0.985722130697419,0.2577565632458234,0.9202768520892078,339,1821,1795,26,285,54,0.8560185185185185,0.5725070830478245,0.5725070830478246
13,0,87,0.6962025316455697,0.8596828447861605,0.1585014409221902,0.9867622724765582,0.25821596244131456,0.918849512069851,347,1813,1789,24,292,55,0.8537037037037037,0.5726318566993741,0.5726318566993742
13,0,88,0.6190476190476191,0.8617533718689788,0.15339233038348082,0.9824272377814388,0.24586288416075652,0.918142160636387,339,1821,1789,32,287,52,0.8523148148148149,0.5679097840824597,0.5679097840824598
13,0,89,0.6551724137931034,0.864447660395562,0.16863905325443787,0.9835345773874863,0.26823529411764707,0.9201540436456996,338,1822,1792,30,281,57,0.8560185185185185,0.5760868153209622,0.5760868153209621
13,0,90,0.6046511627906976,0.8640308582449373,0.15568862275449102,0.9813800657174151,0.24761904761904763,0.918974358974359,334,1826,1792,34,282,52,0.8537037037037037,0.5685343442359532,0.5685343442359531
13,0,91,0.6867469879518072,0.8656716417910447,0.16964285714285715,0.9857456140350878,0.2720763723150358,0.9218149192514741,336,1824,1798,26,279,57,0.8587962962962963,0.5776942355889725,0.5776942355889725
13,0,92,0.6705882352941176,0.8626506024096385,0.16666666666666666,0.9845984598459846,0.26697892271662765,0.9195992807603391,342,1818,1790,28,285,57,0.8550925925925926,0.5756325632563257,0.5756325632563256
13,0,93,0.7375,0.8596153846153847,0.16809116809116809,0.988391376451078,0.27378190255220414,0.9195165852404218,351,1809,1788,21,292,59,0.8550925925925926,0.5782412722711231,0.578241272271123
13,0,94,0.6555555555555556,0.8632850241545894,0.17251461988304093,0.982948294829483,0.27314814814814814,0.9192386831275721,342,1818,1787,31,283,59,0.8546296296296296,0.577731457356262,0.577731457356262
13,0,95,0.6483516483516484,0.861285645239246,0.17052023121387283,0.9823594266813671,0.2700228832951945,0.9178470254957508,346,1814,1782,32,287,59,0.8523148148148149,0.5764398289476199,0.57643982894762
13,0,96,0.7195121951219512,0.8609239653512993,0.16954022988505746,0.9873068432671082,0.2744186046511628,0.9197943444730078,348,1812,1789,23,289,59,0.8555555555555555,0.5784235365760828,0.5784235365760828
13,0,97,0.6666666666666666,0.863768115942029,0.17543859649122806,0.9834983498349835,0.2777777777777778,0.9197530864197532,342,1818,1788,30,282,60,0.8555555555555555,0.5794684731631059,0.5794684731631058
13,0,98,0.7105263157894737,0.8608445297504799,0.1569767441860465,0.987885462555066,0.2571428571428571,0.92,344,1816,1794,22,290,54,0.8555555555555555,0.5724311033705562,0.5724311033705562
13,0,99,0.7183098591549296,0.8544758257539492,0.14366197183098592,0.9889196675900277,0.23943661971830987,0.9167950693374421,355,1805,1785,20,304,51,0.85,0.5662908197105069,0.5662908197105068
15,0,0,0.6756756756756757,0.8619367209971237,0.14792899408284024,0.986827661909989,0.24271844660194178,0.9201637666325486,338,1822,1798,24,288,50,0.8555555555555555,0.5673783279964146,0.5673783279964146
15,0,1,0.5882352941176471,0.8618546845124283,0.12158054711246201,0.9847078099399236,0.20151133501259447,0.9191944940096864,329,1831,1803,28,289,40,0.8532407407407407,0.5531441785261928,0.5531441785261928
15,0,2,0.6764705882352942,0.861376673040153,0.13690476190476192,0.9879385964912281,0.22772277227722776,0.9203268641470889,336,1824,1802,22,290,46,0.8555555555555555,0.5624216791979949,0.5624216791979949
15,0,3,0.7066666666666667,0.8623501199040767,0.15588235294117647,0.987912087912088,0.25542168674698795,0.9208706786171575,340,1820,1798,22,287,53,0.8569444444444444,0.5718972204266322,0.5718972204266322
15,0,4,0.7205882352941176,0.861376673040153,0.14454277286135694,0.9895661724327293,0.2407862407862408,0.9210324559161768,339,1821,1802,19,290,49,0.8569444444444444,0.5670544726470431,0.5670544726470431
15,0,5,0.6578947368421053,0.8618042226487524,0.14792899408284024,0.9857299670691547,0.24154589371980678,0.9196108550947261,338,1822,1796,26,288,50,0.8546296296296296,0.5668294805759976,0.5668294805759975
15,0,6,0.7692307692307693,0.8630071599045346,0.14836795252225518,0.9917718047174986,0.24875621890547261,0.9229198570699335,337,1823,1808,15,287,50,0.8601851851851852,0.5700698786198769,0.5700698786198769
15,0,7,0.7796610169491526,0.8562589243217515,0.13218390804597702,0.9928256070640177,0.22604422604422605,0.9194991055456172,348,1812,1799,13,302,46,0.8541666666666666,0.5625047575549973,0.5625047575549973
15,0,8,0.676056338028169,0.8587841072283389,0.13994169096209913,0.9873417721518988,0.2318840579710145,0.9185867895545314,343,1817,1794,23,295,48,0.8527777777777777,0.5636417315569989,0.5636417315569989
15,0,9,0.726027397260274,0.859127934834691,0.15273775216138327,0.9889685603971319,0.2523809523809524,0.9194871794871795,347,1813,1793,20,294,53,0.8546296296296296,0.5708531562792576,0.5708531562792576
15,0,10,0.6571428571428571,0.8636363636363636,0.13897280966767372,0.9868780754510662,0.22942643391521195,0.9211533554478183,331,1829,1805,24,285,46,0.8569444444444444,0.5629254425593699,0.5629254425593699
15,0,11,0.7073170731707317,0.8662175168431184,0.17261904761904762,0.9868421052631579,0.27751196172248804,0.9226037929267042,336,1824,1800,24,278,58,0.8601851851851852,0.5797305764411028,0.5797305764411028
15,0,12,0.6712328767123288,0.8634403449928126,0.1467065868263473,0.9868565169769989,0.24078624078624075,0.9210324559161768,334,1826,1802,24,285,49,0.8569444444444444,0.5667815519016731,0.5667815519016731
15,0,13,0.7027027027027027,0.8652924256951102,0.15615615615615616,0.9879584017515052,0.25552825552825553,0.9225658062867366,333,1827,1805,22,281,52,0.8597222222222223,0.5720572789538306,0.5720572789538307
15,0,14,0.7681159420289855,0.8593974175035868,0.15273775216138327,0.9911748483177054,0.2548076923076923,0.920594262295082,347,1813,1797,16,294,53,0.8564814814814815,0.5719563002395444,0.5719563002395444
15,0,15,0.6986301369863014,0.8629611883085769,0.1513353115727003,0.9879319802523313,0.24878048780487805,0.921227621483376,337,1823,1801,22,286,51,0.8574074074074074,0.5696336459125158,0.5696336459125159
15,0,16,0.7183098591549296,0.8606988989947343,0.14912280701754385,0.988998899889989,0.24697336561743338,0.9203992833375992,342,1818,1798,20,291,51,0.8560185185185185,0.5690608534537664,0.5690608534537664
15,0,17,0.7384615384615385,0.8587112171837709,0.13953488372093023,0.9906387665198237,0.23471882640586797,0.9199693173101509,344,1816,1799,17,296,48,0.8550925925925926,0.565086825120377,0.565086825120377
15,0,18,0.7323943661971831,0.861656294877932,0.15249266862170088,0.9895547003848268,0.2524271844660194,0.9211873080859775,341,1819,1800,19,289,52,0.8574074074074074,0.5710236845032639,0.5710236845032638
15,0,19,0.734375,0.857824427480916,0.13623188405797101,0.990633608815427,0.22982885085574573,0.9194579391459984,345,1815,1798,17,298,47,0.8541666666666666,0.5634327464366989,0.563432746436699
15,0,20,0.7333333333333333,0.8566666666666667,0.12753623188405797,0.9911845730027549,0.21728395061728395,0.919029374201788,345,1815,1799,16,301,44,0.8532407407407407,0.5593604024434065,0.5593604024434063
15,0,21,0.7692307692307693,0.8568019093078759,0.14285714285714285,0.9917127071823204,0.24096385542168672,0.9193341869398206,350,1810,1795,15,300,50,0.8541666666666666,0.5672849250197316,0.5672849250197316
15,0,22,0.7352941176470589,0.8580305927342257,0.1440922190201729,0.9900717043574186,0.24096385542168675,0.9193341869398208,347,1813,1795,18,297,50,0.8541666666666666,0.5670819616887958,0.5670819616887958
15,0,23,0.7727272727272727,0.8619866284622731,0.15,0.9917582417582418,0.25123152709359603,0.9223300970873786,340,1820,1805,15,289,51,0.8592592592592593,0.5708791208791208,0.5708791208791208
15,0,24,0.765625,0.8568702290076335,0.14040114613180515,0.9917172832689122,0.23728813559322035,0.9193754799078575,349,1811,1796,15,300,49,0.8541666666666666,0.5660592147003587,0.5660592147003587
15,0,25,0.68,0.860431654676259,0.14912280701754385,0.9867986798679867,0.24460431654676257,0.9192928516525749,342,1818,1794,24,291,51,0.8541666666666666,0.5679607434427653,0.5679607434427654
15,0,26,0.7391304347826086,0.8546150167384027,0.14366197183098592,0.990027700831025,0.24056603773584906,0.9173511293634496,355,1805,1787,18,304,51,0.850925925925926,0.5668448363310055,0.5668448363310055
15,0,27,0.7540983606557377,0.8570747975226298,0.1329479768786127,0.9917309812568909,0.22604422604422603,0.9194991055456172,346,1814,1799,15,300,46,0.8541666666666666,0.5623394790677518,0.5623394790677517
15,0,28,0.8032786885245902,0.8561219628394473,0.1396011396011396,0.9933665008291874,0.2378640776699029,0.9196519959058342,351,1809,1797,12,302,49,0.8546296296296296,0.5664838202151635,0.5664838202151635
15,0,29,0.7846153846153846,0.8582338902147971,0.14655172413793102,0.9922737306843267,0.24697336561743338,0.9203992833375992,348,1812,1798,14,297,51,0.8560185185185185,0.5694127274111289,0.5694127274111289
15,0,30,0.7910447761194029,0.8595317725752508,0.15273775216138327,0.9922779922779923,0.25603864734299514,0.9211469534050178,347,1813,1799,14,294,53,0.8574074074074074,0.5725078722196878,0.5725078722196878
15,0,31,0.75,0.8566666666666667,0.13005780346820808,0.9917309812568909,0.22167487684729065,0.9192641798671436,346,1814,1799,15,301,45,0.8537037037037037,0.5608943923625495,0.5608943923625495
15,0,32,0.647887323943662,0.8621349928195309,0.1377245508982036,0.9863088718510405,0.22716049382716053,0.9200510855683269,334,1826,1801,25,288,46,0.8550925925925926,0.5620167113746222,0.5620167113746221
15,0,33,0.7014925373134329,0.8604873387482083,0.13864306784660768,0.9890170236133993,0.2315270935960591,0.9202861522738887,339,1821,1801,20,292,47,0.8555555555555555,0.5638300457300035,0.5638300457300034
15,0,34,0.746268656716418,0.8537983755375059,0.1404494382022472,0.9905764966740577,0.2364066193853428,0.9171157300487555,356,1804,1787,17,306,50,0.850462962962963,0.5655129674381524,0.5655129674381525
15,0,35,0.7083333333333334,0.8601532567049809,0.14868804664723032,0.988442487616951,0.24578313253012046,0.9198463508322664,343,1817,1796,21,292,51,0.8550925925925926,0.5685652671320905,0.5685652671320907
15,0,36,0.7142857142857143,0.8545541249403911,0.12857142857142856,0.9900552486187846,0.21791767554479416,0.9173278730483747,350,1810,1792,18,305,45,0.850462962962963,0.5593133385951066,0.5593133385951066
15,0,37,0.7121212121212122,0.8567335243553008,0.13544668587896252,0.9895201323772752,0.22760290556900725,0.9183516764781161,347,1813,1794,19,300,47,0.8523148148148149,0.5624834091281188,0.5624834091281189
15,0,38,0.7333333333333333,0.8565947242206235,0.1553672316384181,0.9889258028792912,0.2564102564102564,0.9180159342071447,354,1806,1786,20,299,55,0.8523148148148149,0.5721465172588546,0.5721465172588546
15,0,39,0.6571428571428571,0.8569377990430622,0.13333333333333333,0.9867768595041322,0.22168674698795182,0.9172855313700384,345,1815,1791,24,299,46,0.850462962962963,0.5600550964187327,0.5600550964187327
15,0,40,0.75,0.8580305927342257,0.14655172413793102,0.9906181015452539,0.24519230769230765,0.9195696721311476,348,1812,1795,17,297,51,0.8546296296296296,0.5685849128415925,0.5685849128415925
15,0,41,0.7101449275362319,0.8637015781922525,0.1467065868263473,0.9890470974808324,0.24317617866004962,0.922134286443707,334,1826,1806,20,285,49,0.8587962962962963,0.5678768421535899,0.5678768421535899
15,0,42,0.654320987654321,0.8624338624338624,0.15634218289085547,0.9846238330587589,0.2523809523809524,0.9194871794871796,339,1821,1793,28,286,53,0.8546296296296296,0.5704830079748072,0.5704830079748071
15,0,43,0.6857142857142857,0.8583732057416268,0.13953488372093023,0.987885462555066,0.23188405797101447,0.9185867895545314,344,1816,1794,22,296,48,0.8527777777777777,0.5637101731379982,0.5637101731379981
15,0,44,0.7796610169491526,0.8562589243217515,0.13218390804597702,0.9928256070640177,0.22604422604422605,0.9194991055456172,348,1812,1799,13,302,46,0.8541666666666666,0.5625047575549973,0.5625047575549973
15,0,45,0.7428571428571429,0.8631578947368421,0.15384615384615385,0.9901207464324918,0.25490196078431376,0.9222903885480572,338,1822,1804,18,286,52,0.8592592592592593,0.5719834501393227,0.5719834501393228
15,0,46,0.7213114754098361,0.8537398761314912,0.12535612535612536,0.9906025428413489,0.21359223300970875,0.9170931422722619,351,1809,1792,17,307,44,0.85,0.557979334098737,0.5579793340987371
15,0,47,0.6986301369863014,0.8605654048873982,0.14912280701754385,0.9878987898789879,0.24578313253012046,0.9198463508322665,342,1818,1796,22,291,51,0.8550925925925926,0.5685107984482659,0.5685107984482659
15,0,48,0.7083333333333334,0.8587164750957854,0.14739884393063585,0.9884233737596472,0.24401913875598086,0.9190158892875449,346,1814,1793,21,295,51,0.8537037037037037,0.5679111088451416,0.5679111088451415
15,0,49,0.6883116883116883,0.8622179548727796,0.15588235294117647,0.9868131868131869,0.2541966426858513,0.9203177043300026,340,1820,1796,24,287,53,0.8560185185185185,0.5713477698771816,0.5713477698771816
15,0,50,0.7121212121212122,0.8600764087870105,0.13823529411764707,0.9895604395604396,0.23152709359605914,0.9202861522738887,340,1820,1801,19,293,47,0.8555555555555555,0.5638978668390433,0.5638978668390433
15,0,51,0.6933333333333334,0.8652278177458034,0.15615615615615616,0.9874110563765737,0.2549019607843137,0.9222903885480573,333,1827,1804,23,281,52,0.8592592592592593,0.5717836062663649,0.5717836062663649
15,0,52,0.7142857142857143,0.8583732057416268,0.14450867052023122,0.9889746416758545,0.2403846153846154,0.9190573770491804,346,1814,1794,20,296,50,0.8537037037037037,0.5667416560980428,0.5667416560980428
15,0,53,0.7307692307692307,0.8635926993275697,0.16715542521994134,0.9884551951621771,0.2720763723150358,0.921814919251474,341,1819,1798,21,284,57,0.8587962962962963,0.5778053101910592,0.5778053101910592
15,0,54,0.7368421052631579,0.8516405135520685,0.11864406779661017,0.9916943521594684,0.20437956204379562,0.9163468917881812,354,1806,1791,15,312,42,0.8486111111111111,0.5551692099780392,0.5551692099780393
15,0,55,0.704225352112676,0.8630923887027285,0.1488095238095238,0.9884868421052632,0.24570024570024568,0.9215435727063634,336,1824,1803,21,286,50,0.8578703703703704,0.5686481829573934,0.5686481829573935
15,0,56,0.7301587301587301,0.8597997138769671,0.13529411764705881,0.9906593406593407,0.228287841191067,0.9206025019147307,340,1820,1803,17,294,46,0.8560185185185185,0.5629767291531997,0.5629767291531997
15,0,57,0.7571428571428571,0.8617224880382776,0.15497076023391812,0.9906490649064906,0.25728155339805825,0.921699078812692,342,1818,1801,17,289,53,0.8583333333333333,0.5728099125702043,0.5728099125702044
15,0,58,0.6285714285714286,0.854066985645933,0.12607449856733524,0.9856432909994478,0.21002386634844872,0.915149961548321,349,1811,1785,26,305,44,0.8467592592592592,0.5558588947833916,0.5558588947833916
15,0,59,0.6506024096385542,0.861819932595089,0.15835777126099707,0.9840571742715778,0.25471698113207547,0.9188911704312115,341,1819,1790,29,287,54,0.8537037037037037,0.5712074727662875,0.5712074727662875
15,0,60,0.765625,0.8549618320610687,0.1388101983002833,0.991698948533481,0.23501199040767387,0.9182679989751473,353,1807,1792,15,304,49,0.8523148148148149,0.565254573416882,0.5652545734168821
15,0,61,0.7903225806451613,0.8570066730219257,0.14040114613180515,0.992821645499724,0.23844282238442824,0.9199283704272193,349,1811,1798,13,300,49,0.8550925925925926,0.5666113958157646,0.5666113958157646
15,0,62,0.7230769230769231,0.8649164677804296,0.14242424242424243,0.9901639344262295,0.23797468354430382,0.9233121019108281,330,1830,1812,18,283,47,0.8606481481481482,0.566294088425236,0.566294088425236
15,0,63,0.6585365853658537,0.8589990375360924,0.15561959654178675,0.9845559845559846,0.2517482517482518,0.917501927525058,347,1813,1785,28,293,54,0.8513888888888889,0.5700877905488857,0.5700877905488857
15,0,64,0.7101449275362319,0.8570062171209948,0.14080459770114942,0.9889624724061811,0.23501199040767387,0.9182679989751473,348,1812,1792,20,299,49,0.8523148148148149,0.5648835350536652,0.5648835350536652
15,0,65,0.75,0.8656429942418427,0.16913946587537093,0.9895776193088316,0.2760290556900727,0.9234706936268235,337,1823,1804,19,280,57,0.861574074074074,0.5793585425921012,0.5793585425921012
15,0,66,0.6455696202531646,0.8625660740028832,0.1513353115727003,0.9846407021393307,0.24519230769230768,0.9195696721311475,337,1823,1795,28,286,51,0.8546296296296296,0.5679880068560156,0.5679880068560155
15,0,67,0.7321428571428571,0.8569391634980988,0.11988304093567251,0.9917491749174917,0.20603015075376882,0.9194288628250893,342,1818,1803,15,301,41,0.8537037037037037,0.5558161079265822,0.5558161079265821
15,0,68,0.7213114754098361,0.857551214864221,0.1282798833819242,0.9906439185470556,0.21782178217821785,0.919305413687436,343,1817,1800,17,299,44,0.8537037037037037,0.5594619009644899,0.5594619009644899
15,0,69,0.8032786885245902,0.8608861362553597,0.1436950146627566,0.9934029686641012,0.2437810945273632,0.9224093925472181,341,1819,1807,12,292,49,0.8592592592592593,0.5685489916634289,0.5685489916634289
15,0,70,0.7,0.861244019138756,0.14454277286135694,0.9884678747940692,0.23960880195599024,0.9204806954743033,339,1821,1800,21,290,49,0.8560185185185185,0.566505323827713,0.5665053238277131
15,0,71,0.6891891891891891,0.8604985618408437,0.14912280701754385,0.9873487348734874,0.24519230769230765,0.9195696721311475,342,1818,1795,23,291,51,0.8546296296296296,0.5682357709455156,0.5682357709455156
15,0,72,0.7323943661971831,0.85830540928674,0.14942528735632185,0.989514348785872,0.24821002386634844,0.9192514739810304,348,1812,1793,19,296,52,0.8541666666666666,0.5694698180710969,0.5694698180710969
15,0,73,0.7014925373134329,0.8571428571428571,0.13583815028901733,0.9889746416758545,0.22760290556900722,0.9183516764781161,346,1814,1794,20,299,47,0.8523148148148149,0.5624063959824359,0.5624063959824359
15,0,74,0.7272727272727273,0.8553008595988538,0.13675213675213677,0.9900497512437811,0.23021582733812954,0.9177555726364336,351,1809,1791,18,303,48,0.8513888888888889,0.5634009439979589,0.5634009439979589
15,0,75,0.7534246575342466,0.8634403449928126,0.16176470588235295,0.9901098901098901,0.2663438256658596,0.9224468901970821,340,1820,1802,18,285,55,0.8597222222222223,0.5759372979961216,0.5759372979961215
15,0,76,0.7540983606557377,0.8551691281562649,0.13142857142857142,0.9917127071823204,0.2238442822384428,0.9183934510104886,350,1810,1795,15,304,46,0.8523148148148149,0.5615706393054459,0.5615706393054459
15,0,77,0.7236842105263158,0.8637236084452975,0.16224188790560473,0.9884678747940692,0.26506024096385544,0.9218950064020486,339,1821,1800,21,284,55,0.8587962962962963,0.5753548813498369,0.5753548813498369
15,0,78,0.75,0.8580952380952381,0.13119533527696792,0.9917446340121079,0.22332506203473942,0.9200919070717385,343,1817,1802,15,298,45,0.8550925925925926,0.5614699846445379,0.5614699846445379
15,0,79,0.7121212121212122,0.8562559694364852,0.13505747126436782,0.989514348785872,0.22705314009661837,0.9180747567844341,348,1812,1793,19,301,47,0.8518518518518519,0.5622859100251199,0.56228591002512
15,0,80,0.75,0.8554389312977099,0.13675213675213677,0.9911553344389166,0.2313253012048193,0.9183098591549295,351,1809,1793,16,303,48,0.8523148148148149,0.5639537355955266,0.5639537355955266
15,0,81,0.7538461538461538,0.8568019093078759,0.14040114613180515,0.9911651021535064,0.23671497584541062,0.9190988223246288,349,1811,1795,16,300,49,0.8537037037037037,0.5657831241426557,0.5657831241426559
15,0,82,0.7794117647058824,0.862810707456979,0.15588235294117647,0.9917582417582418,0.25980392156862747,0.9228016359918202,340,1820,1805,15,287,53,0.8601851851851852,0.5738202973497091,0.5738202973497091
15,0,83,0.7246376811594203,0.8603538976566236,0.14619883040935672,0.9895489548954896,0.24330900243309,0.9204400102327961,342,1818,1799,19,292,50,0.8560185185185185,0.5678738926524232,0.5678738926524232
15,0,84,0.7285714285714285,0.8602870813397129,0.14868804664723032,0.9895432030820033,0.2469733656174334,0.920399283337599,343,1817,1798,19,292,51,0.8560185185185185,0.5691156248646168,0.5691156248646168
15,0,85,0.6865671641791045,0.8595317725752508,0.13529411764705881,0.9884615384615385,0.22604422604422605,0.9194991055456171,340,1820,1799,21,294,46,0.8541666666666666,0.5618778280542986,0.5618778280542986
15,0,86,0.6883116883116883,0.85741718674988,0.15142857142857144,0.9867403314917127,0.24824355971896958,0.9175443103005394,350,1810,1786,24,297,53,0.8513888888888889,0.5690844514601421,0.5690844514601421
15,0,87,0.7647058823529411,0.858508604206501,0.14942528735632185,0.9911699779249448,0.25,0.9200819672131149,348,1812,1796,16,296,52,0.8555555555555555,0.5702976326406333,0.5702976326406333
15,0,88,0.6575342465753424,0.8624820316243411,0.14328358208955225,0.9863013698630136,0.23529411764705882,0.9202453987730062,335,1825,1800,25,287,48,0.8555555555555555,0.5647924759762828,0.564792475976283
15,0,89,0.65625,0.8563931297709924,0.12244897959183673,0.9878921298844249,0.20638820638820637,0.917454638384871,343,1817,1795,22,301,42,0.850462962962963,0.5551705547381307,0.5551705547381308
15,0,90,0.6666666666666666,0.8602305475504323,0.15160349854227406,0.9856906989543203,0.24703087885985747,0.9186971018209797,343,1817,1791,26,291,52,0.8532407407407407,0.5686470987482971,0.5686470987482971
15,0,91,0.7419354838709677,0.8598665395614872,0.13529411764705881,0.9912087912087912,0.2288557213930348,0.920877998979071,340,1820,1804,16,294,46,0.8564814814814815,0.563251454427925,0.563251454427925
15,0,92,0.7236842105263158,0.8589251439539347,0.15759312320916904,0.988404196576477,0.2588235294117647,0.9191270860077022,349,1811,1790,21,294,55,0.8541666666666666,0.5729986598928231,0.5729986598928231
15,0,93,0.6865671641791045,0.8585762064022934,0.13450292397660818,0.9884488448844885,0.22493887530562343,0.9189465609818461,342,1818,1797,21,296,46,0.8532407407407407,0.5614758844305483,0.5614758844305484
15,0,94,0.6923076923076923,0.8596658711217183,0.13274336283185842,0.9890170236133993,0.2227722772277228,0.9198161389172624,339,1821,1801,20,294,45,0.8546296296296296,0.5608801932226288,0.5608801932226288
15,0,95,0.6708860759493671,0.861604997597309,0.15542521994134897,0.9857064321055525,0.2523809523809524,0.9194871794871795,341,1819,1793,26,288,53,0.8546296296296296,0.5705658260234509,0.5705658260234507
15,0,96,0.684931506849315,0.8543363679923335,0.14124293785310735,0.987264673311185,0.234192037470726,0.9160030824556896,354,1806,1783,23,304,50,0.8486111111111111,0.5642538055821461,0.5642538055821462
15,0,97,0.7361111111111112,0.860632183908046,0.15406976744186046,0.9895374449339207,0.2548076923076923,0.9205942622950819,344,1816,1797,19,291,53,0.8564814814814815,0.5718036061878906,0.5718036061878906
15,0,98,0.7361111111111112,0.860632183908046,0.15406976744186046,0.9895374449339207,0.2548076923076923,0.9205942622950819,344,1816,1797,19,291,53,0.8564814814814815,0.5718036061878906,0.5718036061878906
15,0,99,0.6987951807228916,0.8642272508425614,0.17058823529411765,0.9862637362637363,0.27423167848699764,0.9212214523992814,340,1820,1795,25,282,58,0.8578703703703704,0.578425985778927,0.5784259857789269
17,0,0,0.6885245901639344,0.8542162934730824,0.1206896551724138,0.989514348785872,0.20537897310513448,0.9169010483252364,348,1812,1793,19,306,42,0.8495370370370371,0.5551020019791428,0.5551020019791428
17,0,1,0.7058823529411765,0.8594646271510517,0.14035087719298245,0.988998899889989,0.23414634146341465,0.9196930946291559,342,1818,1798,20,294,48,0.8546296296296296,0.5646748885414857,0.5646748885414857
17,0,2,0.6885245901639344,0.8599333015721772,0.125,0.9895833333333334,0.21158690176322417,0.9202141218455264,336,1824,1805,19,294,42,0.8550925925925926,0.5572916666666666,0.5572916666666667
17,0,3,0.65625,0.8587786259541985,0.1242603550295858,0.9879253567508233,0.208955223880597,0.9188361408882083,338,1822,1800,22,296,42,0.8527777777777777,0.5560928558902045,0.5560928558902045
17,0,4,0.6615384615384615,0.8529832935560859,0.1225071225071225,0.9878385848535103,0.20673076923076922,0.9154713114754098,351,1809,1787,22,308,43,0.8472222222222222,0.5551728536803164,0.5551728536803164
17,0,5,0.6451612903225806,0.8541468064823642,0.11560693641618497,0.9878721058434399,0.19607843137254902,0.9161554192229038,346,1814,1792,22,306,40,0.8481481481481481,0.5517395211298124,0.5517395211298125
17,0,6,0.7058823529411765,0.8546845124282982,0.13636363636363635,0.9889380530973452,0.22857142857142856,0.9169230769230768,352,1808,1788,20,304,48,0.85,0.5626508447304907,0.5626508447304908
17,0,7,0.6956521739130435,0.8589191774270684,0.13994169096209913,0.988442487616951,0.23300970873786406,0.9191402251791199,343,1817,1796,21,295,48,0.8537037037037037,0.564192089289525,0.564192089289525
17,0,8,0.6825396825396826,0.8583690987124464,0.1264705882352941,0.989010989010989,0.21339950372208435,0.9190707173857544,340,1820,1800,20,297,43,0.8532407407407407,0.5577407886231416,0.5577407886231416
17,0,9,0.7575757575757576,0.8595988538681948,0.14534883720930233,0.9911894273127754,0.24390243902439024,0.9207161125319693,344,1816,1800,16,294,50,0.8564814814814815,0.5682691322610389,0.5682691322610388
17,0,10,0.7796610169491526,0.8529271775345074,0.1295774647887324,0.992797783933518,0.22222222222222224,0.917562724014337,355,1805,1792,13,309,46,0.850925925925926,0.5611876243611252,0.5611876243611252
17,0,11,0.6417910447761194,0.8566650740563784,0.12536443148688048,0.9867914144193726,0.20975609756097563,0.9171355498721226,343,1817,1793,24,300,43,0.85,0.5560779229531265,0.5560779229531265
17,0,12,0.7,0.861904761904762,0.12650602409638553,0.9901531728665208,0.21428571428571425,0.9215885947046843,332,1828,1810,18,290,42,0.8574074074074074,0.5583295984814532,0.5583295984814532
17,0,13,0.6567164179104478,0.8561872909698997,0.12753623188405797,0.9873278236914601,0.21359223300970873,0.917093142272262,345,1815,1792,23,301,44,0.85,0.5574320277877591,0.557432027787759
17,0,14,0.696969696969697,0.8576886341929322,0.13372093023255813,0.9889867841409692,0.22439024390243897,0.9186700767263427,344,1816,1796,20,298,46,0.8527777777777777,0.5613538571867637,0.5613538571867637
17,0,15,0.75,0.8597328244274809,0.14035087719298245,0.9911991199119912,0.23645320197044334,0.9207971384772611,342,1818,1802,16,294,48,0.8564814814814815,0.5657749985524868,0.5657749985524868
17,0,16,0.7272727272727273,0.8546318289786223,0.11560693641618497,0.9917309812568909,0.19950124688279303,0.9180913498341413,346,1814,1799,15,306,40,0.8513888888888889,0.5536689588365379,0.5536689588365379
17,0,17,0.6764705882352942,0.859942638623327,0.13569321533923304,0.9879187259747392,0.22604422604422603,0.9194991055456171,339,1821,1799,22,293,46,0.8541666666666666,0.561805970656986,0.5618059706569861
17,0,18,0.7272727272727273,0.8586437440305635,0.13953488372093023,0.9900881057268722,0.23414634146341462,0.919693094629156,344,1816,1798,18,296,48,0.8546296296296296,0.5648114947239012,0.5648114947239012
17,0,19,0.7931034482758621,0.8587059942911512,0.13411078717201166,0.9933957072096863,0.22942643391521197,0.9211533554478182,343,1817,1805,12,297,46,0.8569444444444444,0.563753247190849,0.563753247190849
17,0,20,0.6428571428571429,0.8545454545454545,0.12893982808022922,0.9861954721148537,0.21479713603818615,0.9156626506024096,349,1811,1786,25,304,45,0.8476851851851852,0.5575676500975415,0.5575676500975415
17,0,21,0.6491228070175439,0.8535425582501189,0.1072463768115942,0.9889807162534435,0.18407960199004975,0.9162838182746299,345,1815,1795,20,308,37,0.8481481481481481,0.5481135465325188,0.5481135465325189
17,0,22,0.7049180327868853,0.8561219628394473,0.1246376811594203,0.9900826446280991,0.21182266009852216,0.9182422074603985,345,1815,1797,18,302,43,0.8518518518518519,0.5573601628937597,0.5573601628937597
17,0,23,0.6363636363636364,0.8591212989493792,0.12462908011869436,0.9868348875479978,0.20843672456575685,0.9185601225427623,337,1823,1799,24,295,42,0.8523148148148149,0.5557319838333461,0.5557319838333461
17,0,24,0.7121212121212122,0.8624641833810889,0.14029850746268657,0.9895890410958904,0.23441396508728182,0.9216636897167645,335,1825,1806,19,288,47,0.8578703703703704,0.5649437742792884,0.5649437742792884
17,0,25,0.7333333333333333,0.8552380952380952,0.12643678160919541,0.9911699779249448,0.21568627450980393,0.9182004089979551,348,1812,1796,16,304,44,0.8518518518518519,0.5588033797670701,0.5588033797670701
17,0,26,0.6571428571428571,0.8645933014354067,0.1398176291793313,0.9868924085199344,0.23057644110275688,0.9217036470288191,329,1831,1807,24,283,46,0.8578703703703704,0.5633550188496329,0.5633550188496328
17,0,27,0.696969696969697,0.8548233046800382,0.13142857142857142,0.988950276243094,0.22115384615384615,0.9170081967213115,350,1810,1790,20,304,46,0.85,0.5601894238358327,0.5601894238358327
17,0,28,0.746031746031746,0.8569384835479256,0.13544668587896252,0.9911748483177054,0.22926829268292684,0.9191815856777492,347,1813,1797,16,300,47,0.8537037037037037,0.5633107670983339,0.5633107670983339
17,0,29,0.6727272727272727,0.8570071258907364,0.10946745562130178,0.9901207464324918,0.18829516539440203,0.9187675070028011,338,1822,1804,18,301,37,0.8523148148148149,0.5497941010268967,0.5497941010268967
17,0,30,0.6612903225806451,0.8560533841754051,0.119533527696793,0.988442487616951,0.2024691358024691,0.9174968071519796,343,1817,1796,21,302,41,0.850462962962963,0.5539880076568721,0.553988007656872
17,0,31,0.7368421052631579,0.8563956252971945,0.12209302325581395,0.9917400881057269,0.20947630922693264,0.9191120183720337,344,1816,1801,15,302,42,0.8532407407407407,0.5569165556807705,0.5569165556807704
17,0,32,0.6949152542372882,0.8572108519752499,0.12023460410557185,0.9901044529961517,0.20500000000000002,0.9188775510204082,341,1819,1801,18,300,41,0.8527777777777777,0.5551695285508617,0.5551695285508618
17,0,33,0.6896551724137931,0.8553758325404377,0.11627906976744186,0.9900881057268722,0.1990049751243781,0.9178152118427769,344,1816,1798,18,304,40,0.850925925925926,0.553183587747157,0.553183587747157
17,0,34,0.75,0.8552380952380952,0.12893982808022922,0.9917172832689122,0.22004889975550124,0.9184351828176938,349,1811,1796,15,304,45,0.8523148148148149,0.5603285556745707,0.5603285556745707
17,0,35,0.631578947368421,0.8606752258678079,0.1094224924012158,0.9885308574549426,0.18652849740932642,0.9201830198271478,329,1831,1810,21,293,36,0.8546296296296296,0.5489766749280792,0.5489766749280792
17,0,36,0.6282051282051282,0.8621517771373679,0.14583333333333334,0.9841008771929824,0.23671497584541065,0.9190988223246287,336,1824,1795,29,287,49,0.8537037037037037,0.5649671052631579,0.564967105263158
17,0,37,0.7301587301587301,0.8583690987124464,0.13411078717201166,0.9906439185470556,0.22660098522167488,0.9197751660705161,343,1817,1800,17,297,46,0.8546296296296296,0.5623773528595336,0.5623773528595336
17,0,38,0.6935483870967742,0.8579599618684461,0.12609970674486803,0.9895547003848268,0.21339950372208438,0.9190707173857544,341,1819,1800,19,298,43,0.8532407407407407,0.5578272035648474,0.5578272035648474
17,0,39,0.7846153846153846,0.8596658711217183,0.14782608695652175,0.9922865013774105,0.24878048780487805,0.921227621483376,345,1815,1801,14,294,51,0.8574074074074074,0.5700562941669661,0.5700562941669661
17,0,40,0.7377049180327869,0.8589804668889948,0.13196480938416422,0.9912039582188016,0.22388059701492538,0.9203675344563552,341,1819,1803,16,296,45,0.8555555555555555,0.5615843838014828,0.5615843838014829
17,0,41,0.7321428571428571,0.8559885931558935,0.11918604651162791,0.9917400881057269,0.205,0.9188775510204081,344,1816,1801,15,303,41,0.8527777777777777,0.5554630673086774,0.5554630673086773
17,0,42,0.6825396825396826,0.8483547925608012,0.11911357340720222,0.9888827126181212,0.20283018867924527,0.9132443531827517,361,1799,1779,20,318,43,0.8435185185185186,0.5539981430126617,0.5539981430126617
17,0,43,0.7962962962962963,0.8580246913580247,0.12573099415204678,0.993949394939494,0.21717171717171715,0.9209989806320081,342,1818,1807,11,299,43,0.8564814814814815,0.5598401945457704,0.5598401945457704
17,0,44,0.6885245901639344,0.8556455454978561,0.12173913043478261,0.9895316804407713,0.20689655172413796,0.9177312212570261,345,1815,1796,19,303,42,0.850925925925926,0.555635405437777,0.555635405437777
17,0,45,0.6984126984126984,0.8540772532188842,0.12571428571428572,0.9895027624309393,0.21307506053268765,0.916815971333504,350,1810,1791,19,306,44,0.8495370370370371,0.5576085240726125,0.5576085240726125
17,0,46,0.671875,0.8559160305343512,0.1246376811594203,0.9884297520661157,0.21026894865525672,0.9174124264893889,345,1815,1794,21,302,43,0.850462962962963,0.5565337166127681,0.556533716612768
17,0,47,0.6875,0.8568702290076335,0.12790697674418605,0.9889867841409692,0.21568627450980393,0.9182004089979551,344,1816,1796,20,300,44,0.8518518518518519,0.5584468804425776,0.5584468804425776
17,0,48,0.6176470588235294,0.858508604206501,0.1242603550295858,0.9857299670691547,0.20689655172413793,0.917731221257026,338,1822,1796,26,296,42,0.850925925925926,0.5549951610493703,0.5549951610493702
17,0,49,0.7592592592592593,0.8584995251661919,0.12094395280235988,0.9928610653487095,0.20865139949109415,0.9208046855105679,339,1821,1808,13,298,41,0.8560185185185185,0.5569025090755347,0.5569025090755347
17,0,50,0.703125,0.853530534351145,0.1278409090909091,0.9894911504424779,0.21634615384615385,0.9164959016393442,352,1808,1789,19,307,45,0.8490740740740741,0.5586660297666936,0.5586660297666934
17,0,51,0.7288135593220338,0.8586387434554974,0.1264705882352941,0.9912087912087912,0.21553884711779447,0.9201734251466464,340,1820,1804,16,297,43,0.8550925925925926,0.5588396897220427,0.5588396897220427
17,0,52,0.7049180327868853,0.8608861362553597,0.12835820895522387,0.9901369863013698,0.21717171717171718,0.9209989806320081,335,1825,1807,18,292,43,0.8564814814814815,0.5592475976282968,0.5592475976282969
17,0,53,0.7384615384615385,0.8596658711217183,0.14035087719298245,0.9906490649064906,0.23587223587223585,0.9205213391259903,342,1818,1801,17,294,48,0.8560185185185185,0.5654999710497365,0.5654999710497366
17,0,54,0.6885245901639344,0.857551214864221,0.12316715542521994,0.9895547003848268,0.20895522388059704,0.9188361408882083,341,1819,1800,19,299,42,0.8527777777777777,0.5563609279050233,0.5563609279050235
17,0,55,0.6666666666666666,0.8573466476462197,0.11242603550295859,0.9895718990120747,0.19240506329113924,0.9187261146496816,338,1822,1803,19,300,38,0.8523148148148149,0.5509989672575166,0.5509989672575166
17,0,56,0.6984126984126984,0.8502622794468288,0.12290502793296089,0.9894561598224195,0.20902612826603323,0.9145934855091049,358,1802,1783,19,314,44,0.8458333333333333,0.5561805938776901,0.5561805938776903
17,0,57,0.7068965517241379,0.8615604186489058,0.12349397590361445,0.9907002188183808,0.21025641025641026,0.9216284987277354,332,1828,1811,17,291,41,0.8574074074074074,0.5570970973609977,0.5570970973609976
17,0,58,0.65625,0.8625954198473282,0.12727272727272726,0.9879781420765027,0.2131979695431472,0.9210392256749873,330,1830,1808,22,288,42,0.8564814814814815,0.5576254346746149,0.557625434674615
17,0,59,0.7377049180327869,0.8556455454978561,0.12931034482758622,0.9911699779249448,0.22004889975550124,0.9184351828176937,348,1812,1796,16,303,45,0.8523148148148149,0.5602401613762655,0.5602401613762655
17,0,60,0.71875,0.8563931297709924,0.13256484149855907,0.9900717043574186,0.2238442822384428,0.9183934510104886,347,1813,1795,18,301,46,0.8523148148148149,0.5613182729279889,0.5613182729279889
17,0,61,0.703125,0.8554389312977099,0.12931034482758622,0.989514348785872,0.2184466019417476,0.9176049129989764,348,1812,1793,19,303,45,0.850925925925926,0.5594123468067291,0.5594123468067291
17,0,62,0.7,0.8623809523809524,0.1268882175226586,0.9901585565882997,0.21483375959079282,0.9218630694833292,331,1829,1811,18,289,42,0.8578703703703704,0.5585233870554792,0.5585233870554791
17,0,63,0.6714285714285714,0.8545454545454545,0.1339031339031339,0.9872857932559425,0.22327790973871733,0.9161323416260578,351,1809,1786,23,304,47,0.8486111111111111,0.5605944635795382,0.5605944635795381
17,0,64,0.7384615384615385,0.8582338902147971,0.1391304347826087,0.990633608815427,0.23414634146341465,0.919693094629156,345,1815,1798,17,297,48,0.8546296296296296,0.5648820217990178,0.5648820217990178
17,0,65,0.7323943661971831,0.8578267113451412,0.1489971346704871,0.9895085588072888,0.24761904761904763,0.9189743589743591,349,1811,1792,19,297,52,0.8537037037037037,0.569252846738888,0.569252846738888
17,0,66,0.6825396825396826,0.8564616118264187,0.125,0.9889867841409692,0.2113022113022113,0.9179657551750574,344,1816,1796,20,301,43,0.8513888888888889,0.5569933920704846,0.5569933920704846
17,0,67,0.6619718309859155,0.8630923887027285,0.14114114114114115,0.986863711001642,0.23267326732673266,0.9208375893769151,333,1827,1803,24,286,47,0.8564814814814815,0.5640024260713916,0.5640024260713916
17,0,68,0.7049180327868853,0.8585040495474036,0.1264705882352941,0.9901098901098901,0.2144638403990025,0.9196223526409799,340,1820,1802,18,297,43,0.8541666666666666,0.5582902391725921,0.5582902391725921
17,0,69,0.7246376811594203,0.8574844571975132,0.14367816091954022,0.989514348785872,0.2398081534772182,0.9187804253138613,348,1812,1793,19,298,50,0.8532407407407407,0.5665962548527061,0.5665962548527061
17,0,70,0.6712328767123288,0.8605654048873982,0.14411764705882352,0.9868131868131869,0.23728813559322035,0.9193754799078577,340,1820,1796,24,291,49,0.8541666666666666,0.5654654169360052,0.5654654169360052
17,0,71,0.7014925373134329,0.8609651218346871,0.1390532544378698,0.9890230515916575,0.23209876543209876,0.9205619412515964,338,1822,1802,20,291,47,0.8560185185185185,0.5640381530147636,0.5640381530147637
17,0,72,0.625,0.8540076335877863,0.11560693641618497,0.9867695700110254,0.19512195121951217,0.9156010230179029,346,1814,1790,24,306,40,0.8472222222222222,0.5511882532136052,0.5511882532136052
17,0,73,0.7164179104477612,0.8600095556617295,0.14076246334310852,0.9895547003848268,0.23529411764705885,0.920245398773006,341,1819,1800,19,293,48,0.8555555555555555,0.5651585818639677,0.5651585818639677
17,0,74,0.765625,0.8587786259541985,0.14202898550724638,0.9917355371900827,0.23960880195599024,0.9204806954743033,345,1815,1800,15,296,49,0.8560185185185185,0.5668822613486645,0.5668822613486646
17,0,75,0.7735849056603774,0.859515899383009,0.12166172106824925,0.9934174437739989,0.21025641025641026,0.9216284987277353,337,1823,1811,12,296,41,0.8574074074074074,0.5575395824211241,0.5575395824211241
17,0,76,0.6818181818181818,0.8581661891117478,0.13157894736842105,0.9884488448844885,0.22058823529411764,0.9187116564417177,342,1818,1797,21,297,45,0.8527777777777777,0.5600138961264548,0.5600138961264547
17,0,77,0.6949152542372882,0.857686815801999,0.12058823529411765,0.9901098901098901,0.20551378446115287,0.9191532772251977,340,1820,1802,18,299,41,0.8532407407407407,0.5553490627020039,0.5553490627020039
17,0,78,0.671875,0.8563931297709924,0.125,0.9884361233480177,0.2107843137254902,0.9176891615541922,344,1816,1795,21,301,43,0.850925925925926,0.5567180616740088,0.5567180616740088
17,0,79,0.7096774193548387,0.8598665395614872,0.1301775147928994,0.9901207464324918,0.22,0.9204081632653063,338,1822,1804,18,294,44,0.8555555555555555,0.5601491306126956,0.5601491306126956
17,0,80,0.6607142857142857,0.8521863117870723,0.10632183908045977,0.989514348785872,0.18316831683168316,0.9157303370786518,348,1812,1793,19,311,37,0.8472222222222222,0.5479180939331658,0.5479180939331659
17,0,81,0.6714285714285714,0.8569377990430622,0.13583815028901733,0.9873208379272327,0.22596153846153844,0.9175204918032788,346,1814,1791,23,299,47,0.850925925925926,0.561579494108125,0.561579494108125
17,0,82,0.7301587301587301,0.8621840724845017,0.1373134328358209,0.9906849315068493,0.23115577889447236,0.9219785823559409,335,1825,1808,17,289,46,0.8583333333333333,0.5639991821713352,0.5639991821713352
17,0,83,0.746031746031746,0.8574153552694326,0.13583815028901733,0.9911797133406836,0.2298288508557457,0.9194579391459984,346,1814,1798,16,299,47,0.8541666666666666,0.5635089318148504,0.5635089318148504
17,0,84,0.7407407407407407,0.855650522317189,0.11627906976744186,0.9922907488986784,0.20100502512562815,0.9189189189189189,344,1816,1802,14,304,40,0.8527777777777777,0.5542849093330602,0.5542849093330601
17,0,85,0.7,0.861904761904762,0.12650602409638553,0.9901531728665208,0.21428571428571425,0.9215885947046843,332,1828,1810,18,290,42,0.8574074074074074,0.5583295984814532,0.5583295984814532
17,0,86,0.6338028169014085,0.8606988989947343,0.13392857142857142,0.9857456140350878,0.22113022113022116,0.9189879887554305,336,1824,1798,26,291,45,0.8532407407407407,0.5598370927318296,0.5598370927318296
17,0,87,0.7258064516129032,0.8555767397521449,0.12931034482758622,0.9906181015452539,0.21951219512195125,0.9181585677749361,348,1812,1795,17,303,45,0.8518518518518519,0.5599642231864201,0.55996422318642
17,0,88,0.6875,0.8616412213740458,0.1317365269461078,0.9890470974808324,0.22110552763819097,0.9209586945436001,334,1826,1806,20,290,44,0.8564814814814815,0.56039181221347,0.5603918122134701
17,0,89,0.7580645161290323,0.8589132507149666,0.13702623906705538,0.9917446340121079,0.23209876543209876,0.9205619412515964,343,1817,1802,15,296,47,0.8560185185185185,0.5643854365395816,0.5643854365395816
17,0,90,0.6716417910447762,0.8566650740563784,0.13043478260869565,0.9878787878787879,0.21844660194174756,0.9176049129989764,345,1815,1793,22,300,45,0.850925925925926,0.5591567852437417,0.5591567852437418
17,0,91,0.7627118644067796,0.8614945264159923,0.13392857142857142,0.9923245614035088,0.2278481012658228,0.9222929936305732,336,1824,1810,14,291,45,0.8587962962962963,0.5631265664160401,0.5631265664160401
17,0,92,0.7213114754098361,0.8589804668889948,0.12941176470588237,0.9906593406593407,0.21945137157107236,0.920132686909926,340,1820,1803,17,296,44,0.8550925925925926,0.5600355526826115,0.5600355526826115
17,0,93,0.7384615384615385,0.8539379474940334,0.13559322033898305,0.9905869324473976,0.22911694510739858,0.9172007177646756,354,1806,1789,17,306,48,0.850462962962963,0.5630900763931904,0.5630900763931903
17,0,94,0.7166666666666667,0.8595238095238096,0.12721893491124261,0.9906695938529089,0.21608040201005027,0.9204487506374299,338,1822,1805,17,295,43,0.8555555555555555,0.5589442643820758,0.5589442643820757
17,0,95,0.7,0.8574162679425837,0.14121037463976946,0.9884169884169884,0.23501199040767387,0.9182679989751474,347,1813,1792,21,298,49,0.8523148148148149,0.564813681528379,0.564813681528379
17,0,96,0.7333333333333333,0.8628297362110312,0.16129032258064516,0.9890049477735019,0.2644230769230769,0.9216188524590164,341,1819,1799,20,286,55,0.8583333333333333,0.5751476351770736,0.5751476351770735
17,0,97,0.7454545454545455,0.8541567695961996,0.11781609195402298,0.9922737306843267,0.20347394540942929,0.9180495276997702,348,1812,1798,14,307,41,0.8513888888888889,0.5550449113191749,0.5550449113191749
17,0,98,0.7321428571428571,0.8531368821292775,0.11714285714285715,0.9917127071823204,0.20197044334975373,0.9172202350536535,350,1810,1795,15,309,41,0.85,0.5544277821625888,0.5544277821625887
17,0,99,0.6515151515151515,0.8562559694364852,0.125,0.9873348017621145,0.2097560975609756,0.9171355498721228,344,1816,1793,23,301,43,0.85,0.5561674008810572,0.5561674008810573
19,0,0,0.7222222222222222,0.8547008547008547,0.11304347826086956,0.9917355371900827,0.19548872180451127,0.9181331293037491,345,1815,1800,15,306,39,0.8513888888888889,0.5523895077254761,0.5523895077254761
19,0,1,0.6825396825396826,0.8617072007629948,0.12912912912912913,0.9890530925013684,0.21717171717171718,0.9209989806320081,333,1827,1807,20,290,43,0.8564814814814815,0.5590911108152489,0.5590911108152488
19,0,2,0.7457627118644068,0.8562589243217515,0.12716763005780346,0.9917309812568909,0.21728395061728392,0.919029374201788,346,1814,1799,15,302,44,0.8532407407407407,0.5594493056573472,0.5594493056573472
19,0,3,0.6964285714285714,0.8564638783269962,0.11436950146627566,0.9906542056074766,0.1964735516372796,0.9186846800917665,341,1819,1802,17,302,39,0.8523148148148149,0.552511853536876,0.5525118535368762
19,0,4,0.7924528301886793,0.8490745135263408,0.11666666666666667,0.9938888888888889,0.20338983050847456,0.9157921679037625,360,1800,1789,11,318,42,0.8476851851851852,0.5552777777777779,0.5552777777777778
19,0,5,0.7924528301886793,0.8561936402467963,0.12173913043478261,0.9939393939393939,0.21105527638190955,0.9199388067312595,345,1815,1804,11,303,42,0.8546296296296296,0.5578392621870882,0.5578392621870882
19,0,6,0.7407407407407407,0.855650522317189,0.11627906976744186,0.9922907488986784,0.20100502512562815,0.9189189189189189,344,1816,1802,14,304,40,0.8527777777777777,0.5542849093330602,0.5542849093330601
19,0,7,0.7368421052631579,0.8563956252971945,0.12209302325581395,0.9917400881057269,0.20947630922693264,0.9191120183720337,344,1816,1801,15,302,42,0.8532407407407407,0.5569165556807705,0.5569165556807704
19,0,8,0.6825396825396826,0.8574153552694326,0.12573099415204678,0.988998899889989,0.21234567901234566,0.9185185185185186,342,1818,1798,20,299,43,0.8523148148148149,0.5573649470210179,0.5573649470210179
19,0,9,0.6909090909090909,0.8570071258907364,0.11209439528023599,0.9906644700713894,0.19289340101522842,0.9190015282730515,339,1821,1804,17,301,38,0.8527777777777777,0.5513794326758127,0.5513794326758127
19,0,10,0.7547169811320755,0.8514475557664927,0.11331444759206799,0.9928057553956835,0.19704433497536947,0.916709248850281,353,1807,1794,13,313,40,0.8490740740740741,0.5530601014938757,0.5530601014938757
19,0,11,0.7213114754098361,0.8523106241067174,0.12429378531073447,0.9905869324473976,0.21204819277108436,0.9162612035851473,354,1806,1789,17,310,44,0.8486111111111111,0.5574403588790661,0.557440358879066
19,0,12,0.7636363636363637,0.8570071258907364,0.12244897959183673,0.9928453494771602,0.21105527638190955,0.9199388067312596,343,1817,1804,13,301,42,0.8546296296296296,0.5576471645344985,0.5576471645344985
19,0,13,0.7358490566037735,0.8561936402467963,0.11403508771929824,0.9922992299229924,0.19746835443037972,0.9192356687898089,342,1818,1804,14,303,39,0.8532407407407407,0.5531671588211453,0.5531671588211453
19,0,14,0.711864406779661,0.8553069966682532,0.12138728323699421,0.9906284454244763,0.2074074074074074,0.918007662835249,346,1814,1797,17,304,42,0.8513888888888889,0.5560078643307352,0.5560078643307352
19,0,15,0.7301587301587301,0.8569384835479256,0.1329479768786127,0.9906284454244763,0.22493887530562345,0.918946560981846,346,1814,1797,17,300,46,0.8532407407407407,0.5617882111515445,0.5617882111515444
19,0,16,0.711864406779661,0.8553069966682532,0.12138728323699421,0.9906284454244763,0.2074074074074074,0.918007662835249,346,1814,1797,17,304,42,0.8513888888888889,0.5560078643307352,0.5560078643307352
19,0,17,0.7142857142857143,0.8607414448669202,0.12012012012012012,0.9912424740010947,0.20565552699228792,0.9213940473162047,333,1827,1811,16,293,40,0.8569444444444444,0.5556812970606073,0.5556812970606073
19,0,18,0.7777777777777778,0.8570750237416904,0.12244897959183673,0.9933957072096863,0.21158690176322417,0.9202141218455263,343,1817,1805,12,301,42,0.8550925925925926,0.5579223434007614,0.5579223434007615
19,0,19,0.7049180327868853,0.8561219628394473,0.1246376811594203,0.9900826446280991,0.21182266009852216,0.9182422074603985,345,1815,1797,18,302,43,0.8518518518518519,0.5573601628937597,0.5573601628937597
19,0,20,0.7288135593220338,0.857686815801999,0.12573099415204678,0.9911991199119912,0.2144638403990025,0.9196223526409798,342,1818,1802,16,299,43,0.8541666666666666,0.558465057032019,0.558465057032019
19,0,21,0.7142857142857143,0.8564638783269962,0.11695906432748537,0.9911991199119912,0.20100502512562812,0.9189189189189189,342,1818,1802,16,302,40,0.8527777777777777,0.5540790921197383,0.5540790921197383
19,0,22,0.7419354838709677,0.8570066730219257,0.1329479768786127,0.9911797133406836,0.22549019607843135,0.9192229038854807,346,1814,1798,16,300,46,0.8537037037037037,0.5620638451096482,0.5620638451096481
19,0,23,0.7777777777777778,0.8532763532763533,0.11965811965811966,0.9933665008291874,0.2074074074074074,0.9180076628352491,351,1809,1797,12,309,42,0.8513888888888889,0.5565123102436536,0.5565123102436536
19,0,24,0.6610169491525424,0.8500713945740124,0.11016949152542373,0.9889258028792912,0.18886198547215494,0.9142564627591502,354,1806,1786,20,315,39,0.8449074074074074,0.5495476472023574,0.5495476472023575
19,0,25,0.7450980392156863,0.8525367472735894,0.10888252148997135,0.992821645499724,0.19000000000000003,0.9173469387755101,349,1811,1798,13,311,38,0.85,0.5508520834948476,0.5508520834948477
19,0,26,0.7586206896551724,0.8568030447193149,0.12753623188405797,0.9922865013774105,0.2183622828784119,0.9195813122287464,345,1815,1801,14,301,44,0.8541666666666666,0.5599113666307343,0.5599113666307343
19,0,27,0.8070175438596491,0.8568711364717071,0.13256484149855907,0.9939327082184225,0.22772277227722773,0.920326864147089,347,1813,1802,11,301,46,0.8555555555555555,0.5632487748584908,0.5632487748584908
19,0,28,0.7166666666666667,0.8561904761904762,0.1246376811594203,0.990633608815427,0.2123456790123457,0.9185185185185185,345,1815,1798,17,302,43,0.8523148148148149,0.5576356449874237,0.5576356449874236
19,0,29,0.7333333333333333,0.8623809523809524,0.13213213213213212,0.9912424740010947,0.2239185750636132,0.9223325693913929,333,1827,1811,16,289,44,0.8587962962962963,0.5616873030666133,0.5616873030666134
19,0,30,0.7454545454545455,0.8517814726840855,0.11614730878186968,0.9922523519645822,0.20098039215686272,0.9166666666666667,353,1807,1793,14,312,41,0.8490740740740741,0.554199830373226,0.554199830373226
19,0,31,0.7457627118644068,0.857686815801999,0.1282798833819242,0.9917446340121079,0.21890547263681592,0.9198570699336396,343,1817,1802,15,299,44,0.8546296296296296,0.560012258697016,0.560012258697016
19,0,32,0.7014925373134329,0.8600095556617295,0.13823529411764707,0.989010989010989,0.23095823095823098,0.9200102223358038,340,1820,1800,20,293,47,0.8550925925925926,0.563623141564318,0.563623141564318
19,0,33,0.75,0.8590476190476191,0.13196480938416422,0.9917537108301264,0.22443890274314213,0.9206430211788722,341,1819,1804,15,296,45,0.8560185185185185,0.5618592601071453,0.5618592601071454
19,0,34,0.7096774193548387,0.8584366062917064,0.12903225806451613,0.9901044529961517,0.21836228287841192,0.9195813122287464,341,1819,1801,18,297,44,0.8541666666666666,0.5595683555303338,0.5595683555303339
19,0,35,0.75,0.859942638623327,0.14825581395348839,0.9906387665198237,0.24757281553398058,0.9206755373592631,344,1816,1799,17,293,51,0.8564814814814815,0.5694472902366561,0.5694472902366561
19,0,36,0.7454545454545455,0.8560570071258907,0.11918604651162791,0.9922907488986784,0.2055137844611529,0.9191532772251976,344,1816,1802,14,303,41,0.8532407407407407,0.5557383977051532,0.5557383977051532
19,0,37,0.7758620689655172,0.8568030447193149,0.13005780346820808,0.9928335170893055,0.22277227722772275,0.9198161389172625,346,1814,1801,13,301,45,0.8546296296296296,0.5614456602787568,0.5614456602787568
19,0,38,0.7288135593220338,0.857686815801999,0.12573099415204678,0.9911991199119912,0.2144638403990025,0.9196223526409798,342,1818,1802,16,299,43,0.8541666666666666,0.558465057032019,0.558465057032019
19,0,39,0.7321428571428571,0.8564638783269962,0.119533527696793,0.9917446340121079,0.20551378446115287,0.9191532772251976,343,1817,1802,15,302,41,0.8532407407407407,0.5556390808544505,0.5556390808544505
19,0,40,0.6612903225806451,0.8541468064823642,0.11815561959654179,0.9884169884169884,0.20048899755501226,0.9163896701610842,347,1813,1792,21,306,41,0.8486111111111111,0.5532863040067652,0.5532863040067652
19,0,41,0.7272727272727273,0.8600764087870105,0.14076246334310852,0.9901044529961517,0.23587223587223588,0.9205213391259903,341,1819,1801,18,293,48,0.8560185185185185,0.5654334581696301,0.5654334581696301
19,0,42,0.7692307692307693,0.8529411764705882,0.11428571428571428,0.9933701657458563,0.19900497512437812,0.9178152118427769,350,1810,1798,12,310,40,0.850925925925926,0.5538279400157854,0.5538279400157853
19,0,43,0.78,0.8540284360189574,0.11239193083573487,0.9939327082184225,0.1964735516372796,0.9186846800917665,347,1813,1802,11,308,39,0.8523148148148149,0.5531623195270786,0.5531623195270787
19,0,44,0.7192982456140351,0.854493580599144,0.11815561959654179,0.9911748483177054,0.20297029702970298,0.9177732379979571,347,1813,1797,16,306,41,0.850925925925926,0.5546652339571236,0.5546652339571236
19,0,45,0.7241379310344828,0.8525214081826832,0.11931818181818182,0.9911504424778761,0.20487804878048782,0.916624040920716,352,1808,1792,16,310,42,0.8490740740740741,0.555234312148029,0.555234312148029
19,0,46,0.7090909090909091,0.8551068883610451,0.11337209302325581,0.9911894273127754,0.19548872180451127,0.918133129303749,344,1816,1800,16,305,39,0.8513888888888889,0.5522807601680156,0.5522807601680155
19,0,47,0.7758620689655172,0.8582302568981922,0.13119533527696792,0.9928453494771602,0.22443890274314213,0.9206430211788722,343,1817,1804,13,298,45,0.8560185185185185,0.562020342377064,0.562020342377064
19,0,48,0.7884615384615384,0.855787476280835,0.11884057971014493,0.9939393939393939,0.20654911838790932,0.9197043079276065,345,1815,1804,11,304,41,0.8541666666666666,0.5563899868247694,0.5563899868247694
19,0,49,0.7192982456140351,0.8616262482168331,0.12349397590361445,0.9912472647702407,0.21079691516709512,0.9219028237089798,332,1828,1812,16,291,41,0.8578703703703704,0.5573706203369276,0.5573706203369275
19,0,50,0.7272727272727273,0.8565320665083136,0.11695906432748537,0.9917491749174917,0.20151133501259447,0.9191944940096866,342,1818,1803,15,302,40,0.8532407407407407,0.5543541196224886,0.5543541196224885
19,0,51,0.7884615384615384,0.857685009487666,0.12023460410557185,0.9939527212754261,0.20865139949109415,0.9208046855105679,341,1819,1808,11,300,41,0.8560185185185185,0.557093662690499,0.557093662690499
19,0,52,0.7580645161290323,0.8584366062917064,0.13662790697674418,0.9917400881057269,0.2315270935960591,0.9202861522738887,344,1816,1801,15,297,47,0.8555555555555555,0.5641839975412356,0.5641839975412355
19,0,53,0.7291666666666666,0.8503787878787878,0.09971509971509972,0.9928137092316197,0.17543859649122806,0.9160928334608517,351,1809,1796,13,316,35,0.8476851851851852,0.5462644044733598,0.5462644044733598
19,0,54,0.71875,0.8602099236641222,0.13569321533923304,0.9901153212520593,0.228287841191067,0.9206025019147307,339,1821,1803,18,293,46,0.8560185185185185,0.562904268295646,0.5629042682956462
19,0,55,0.639344262295082,0.851357789423535,0.1111111111111111,0.9878385848535103,0.18932038834951453,0.91453428863869,351,1809,1787,22,312,39,0.8453703703703703,0.5494748479823107,0.5494748479823107
19,0,56,0.7301587301587301,0.8564616118264187,0.13256484149855907,0.9906232763375621,0.224390243902439,0.9186700767263427,347,1813,1796,17,301,46,0.8527777777777777,0.5615940589180606,0.5615940589180606
19,0,57,0.7358490566037735,0.8552444233507357,0.11337209302325581,0.9922907488986784,0.19647355163727956,0.9186846800917666,344,1816,1802,14,305,39,0.8523148148148149,0.552831420960967,0.552831420960967
19,0,58,0.711864406779661,0.8610185625892433,0.12574850299401197,0.9906900328587076,0.21374045801526717,0.9213139801375095,334,1826,1809,17,292,42,0.8569444444444444,0.5582192679263598,0.5582192679263598
19,0,59,0.7777777777777778,0.8537511870845205,0.12,0.9933701657458563,0.20792079207920794,0.9182839632277834,350,1810,1798,12,308,42,0.8518518518518519,0.5566850828729283,0.5566850828729282
19,0,60,0.7222222222222222,0.8566001899335233,0.11436950146627566,0.9917537108301264,0.19746835443037974,0.9192356687898088,341,1819,1804,15,302,39,0.8532407407407407,0.553061606148201,0.553061606148201
19,0,61,0.6724137931034483,0.8506184586108468,0.11048158640226628,0.9894853348090759,0.1897810218978102,0.9148119723714506,353,1807,1788,19,314,39,0.8458333333333333,0.5499834606056712,0.549983460605671
19,0,62,0.7818181818181819,0.8513064133016627,0.12078651685393259,0.9933481152993349,0.20924574209245744,0.9168585315937581,356,1804,1792,12,313,43,0.8495370370370371,0.5570673160766337,0.5570673160766337
19,0,63,0.7288135593220338,0.8572108519752499,0.12536443148688048,0.9911942762795817,0.2139303482587065,0.919346605410924,343,1817,1801,16,300,43,0.8537037037037037,0.5582793538832311,0.558279353883231
19,0,64,0.711864406779661,0.8591147072822466,0.1242603550295858,0.9906695938529089,0.2115869017632242,0.9202141218455263,338,1822,1805,17,296,42,0.8550925925925926,0.5574649744412473,0.5574649744412473
19,0,65,0.7758620689655172,0.8601332064700286,0.13274336283185842,0.9928610653487095,0.22670025188916879,0.9217435635992863,339,1821,1808,13,294,45,0.8578703703703704,0.562802214090284,0.562802214090284
19,0,66,0.7413793103448276,0.8553758325404377,0.1239193083573487,0.9917264202978489,0.2123456790123457,0.9185185185185185,347,1813,1798,15,304,43,0.8523148148148149,0.5578228643275988,0.5578228643275988
19,0,67,0.7090909090909091,0.8560570071258907,0.11403508771929824,0.9911991199119912,0.1964735516372796,0.9186846800917665,342,1818,1802,16,303,39,0.8523148148148149,0.5526171038156447,0.5526171038156448
19,0,68,0.7192982456140351,0.8582976699952449,0.12094395280235988,0.9912136188907194,0.20707070707070707,0.9199796126401631,339,1821,1805,16,298,41,0.8546296296296296,0.5560787858465396,0.5560787858465397
19,0,69,0.7169811320754716,0.8528713811105838,0.10919540229885058,0.9917218543046358,0.18952618453865339,0.917070681296249,348,1812,1797,15,310,38,0.8495370370370371,0.5504586283017432,0.5504586283017432
19,0,70,0.7037037037037037,0.8575498575498576,0.11242603550295859,0.991218441273326,0.19387755102040816,0.9195519348268839,338,1822,1806,16,300,38,0.8537037037037037,0.5518222383881423,0.5518222383881424
19,0,71,0.8113207547169812,0.8533459895586142,0.12215909090909091,0.9944690265486725,0.2123456790123457,0.9185185185185185,352,1808,1798,10,309,43,0.8523148148148149,0.5583140587288817,0.5583140587288817
19,0,72,0.746031746031746,0.8593228421554602,0.13742690058479531,0.9911991199119912,0.23209876543209873,0.9205619412515964,342,1818,1802,16,295,47,0.8560185185185185,0.5643130102483932,0.5643130102483932
19,0,73,0.8269230769230769,0.8567362428842504,0.1246376811594203,0.9950413223140496,0.21662468513853905,0.9207239357634464,345,1815,1806,9,302,43,0.8560185185185185,0.5598395017367349,0.5598395017367349
19,0,74,0.7377049180327869,0.8642210576464984,0.13636363636363635,0.9912568306010929,0.23017902813299232,0.9233901756172055,330,1830,1814,16,285,45,0.8606481481481482,0.5638102334823646,0.5638102334823646
19,0,75,0.6885245901639344,0.8570747975226298,0.12280701754385964,0.9895489548954896,0.2084367245657568,0.9185601225427622,342,1818,1799,19,300,42,0.8523148148148149,0.5561779862196745,0.5561779862196746
19,0,76,0.7258064516129032,0.8560533841754051,0.12968299711815562,0.9906232763375621,0.2200488997555012,0.9184351828176937,347,1813,1796,17,302,45,0.8523148148148149,0.5601531367278588,0.5601531367278588
19,0,77,0.6619718309859155,0.8645284825275251,0.14242424242424243,0.9868852459016394,0.2344139650872818,0.9216636897167646,330,1830,1806,24,283,47,0.8578703703703704,0.5646547441629409,0.5646547441629409
19,0,78,0.7454545454545455,0.8560570071258907,0.11918604651162791,0.9922907488986784,0.2055137844611529,0.9191532772251976,344,1816,1802,14,303,41,0.8532407407407407,0.5557383977051532,0.5557383977051532
19,0,79,0.75,0.8668893129770993,0.14678899082568808,0.9912711402073104,0.24552429667519182,0.9249172817510817,327,1833,1817,16,279,48,0.8634259259259259,0.5690300655164993,0.5690300655164993
19,0,80,0.6440677966101694,0.8557829604950024,0.11143695014662756,0.9884551951621771,0.19,0.9173469387755102,341,1819,1798,21,303,38,0.85,0.5499460726544022,0.5499460726544023
19,0,81,0.6388888888888888,0.8625478927203065,0.13813813813813813,0.9857690202517789,0.2271604938271605,0.9200510855683269,333,1827,1801,26,287,46,0.8550925925925926,0.5619535791949586,0.5619535791949586
19,0,82,0.7966101694915254,0.8643503093764874,0.14156626506024098,0.9934354485776805,0.24040920716112535,0.9244082463731229,332,1828,1816,12,285,47,0.8625,0.5675008568189608,0.5675008568189607
19,0,83,0.7647058823529411,0.8530109056424846,0.11174785100286533,0.9933738266151297,0.19499999999999998,0.9178571428571428,349,1811,1799,12,310,39,0.850925925925926,0.5525608388089975,0.5525608388089975
19,0,84,0.7368421052631579,0.8535425582501189,0.12,0.9917127071823204,0.20638820638820637,0.917454638384871,350,1810,1795,15,308,42,0.850462962962963,0.5558563535911603,0.5558563535911603
19,0,85,0.7924528301886793,0.8585666824869482,0.12352941176470589,0.993956043956044,0.2137404580152672,0.9213139801375095,340,1820,1809,11,298,42,0.8569444444444444,0.5587427278603749,0.5587427278603749
19,0,86,0.7096774193548387,0.8579599618684461,0.1286549707602339,0.9900990099009901,0.21782178217821782,0.9193054136874361,342,1818,1800,18,298,44,0.8537037037037037,0.5593769903306121,0.5593769903306121
19,0,87,0.7254901960784313,0.853959222380275,0.1072463768115942,0.9922865013774105,0.18686868686868685,0.917940876656473,345,1815,1801,14,308,37,0.850925925925926,0.5497664390945023,0.5497664390945024
19,0,88,0.7735849056603774,0.8571428571428571,0.11988304093567251,0.9933993399339934,0.20759493670886076,0.9202547770700636,342,1818,1806,12,301,41,0.8550925925925926,0.5566411904348331,0.556641190434833
19,0,89,0.7377049180327869,0.857551214864221,0.1308139534883721,0.9911894273127754,0.22222222222222227,0.9195402298850576,344,1816,1800,16,299,45,0.8541666666666666,0.5610016904005737,0.5610016904005737
19,0,90,0.6451612903225806,0.853670162059104,0.11527377521613832,0.987865416436845,0.19559902200488996,0.9158782919969317,347,1813,1791,22,307,40,0.8476851851851852,0.5515695958264917,0.5515695958264917
19,0,91,0.7166666666666667,0.8571428571428571,0.12536443148688048,0.9906439185470556,0.2133995037220844,0.9190707173857543,343,1817,1800,17,300,43,0.8532407407407407,0.5580041750169681,0.558004175016968
19,0,92,0.74,0.8568720379146919,0.10914454277286136,0.9928610653487095,0.19023136246786634,0.9198677181378784,339,1821,1808,13,302,37,0.8541666666666666,0.5510028040607855,0.5510028040607855
19,0,93,0.7301587301587301,0.8540772532188842,0.13068181818181818,0.9905973451327433,0.2216867469879518,0.9172855313700384,352,1808,1791,17,306,46,0.850462962962963,0.5606395816572807,0.5606395816572808
19,0,94,0.6964285714285714,0.8507604562737643,0.11048158640226628,0.9905921416712784,0.19070904645476772,0.9153669138327793,353,1807,1790,17,314,39,0.8467592592592592,0.5505368640367724,0.5505368640367723
19,0,95,0.7017543859649122,0.8597242035187826,0.11940298507462686,0.9906849315068493,0.2040816326530612,0.9205702647657842,335,1825,1808,17,295,40,0.8555555555555555,0.555043958290738,0.5550439582907382
19,0,96,0.7636363636363637,0.8522565320665083,0.11898016997167139,0.9928057553956835,0.2058823529411765,0.9171779141104294,353,1807,1794,13,311,42,0.85,0.5558929626836775,0.5558929626836775
19,0,97,0.6885245901639344,0.8618389709385421,0.12650602409638553,0.9896061269146609,0.21374045801526714,0.9213139801375096,332,1828,1809,19,290,42,0.8569444444444444,0.5580560755055233,0.5580560755055233
19,0,98,0.7068965517241379,0.857278782112274,0.12023460410557185,0.9906542056074766,0.2055137844611529,0.9191532772251978,341,1819,1802,17,300,41,0.8532407407407407,0.5554444048565242,0.5554444048565242
19,0,99,0.7692307692307693,0.8538899430740038,0.11494252873563218,0.9933774834437086,0.2,0.9183673469387756,348,1812,1800,12,308,40,0.8518518518518519,0.5541600060896704,0.5541600060896704
