K,#Exec,PPV_S,PPV_NS,TPR_S,TPR_NS,F1_S,F1_NS,SUP_S,SUP_NS,TN,FP,FN,TP,Acc
3,0,0.586206896552,0.623188405797,0.646739130435,0.56135770235,0.614987080103,0.590659340659,368,383,215,168,130,238,0.603195739015
3,1,0.582938388626,0.617021276596,0.661290322581,0.53562005277,0.619647355164,0.573446327684,372,379,203,176,126,246,0.597869507324
3,2,0.6125,0.618233618234,0.646437994723,0.583333333333,0.629011553273,0.600276625173,379,372,217,155,134,245,0.61517976032
3,3,0.646464646465,0.642253521127,0.668407310705,0.619565217391,0.657252888318,0.630705394191,383,368,228,140,127,256,0.644474034621
3,4,0.598997493734,0.602272727273,0.630606860158,0.569892473118,0.614395886889,0.585635359116,379,372,212,160,140,239,0.600532623169
3,5,0.594594594595,0.607558139535,0.641909814324,0.558823529412,0.617346938776,0.58217270195,377,374,209,165,135,242,0.600532623169
3,6,0.598014888337,0.603448275862,0.635883905013,0.564516129032,0.616368286445,0.583333333333,379,372,210,162,138,241,0.600532623169
3,7,0.620689655172,0.646376811594,0.673796791444,0.59151193634,0.646153846154,0.617728531856,374,377,223,154,122,252,0.632490013316
3,8,0.634146341463,0.66275659824,0.693333333333,0.601063829787,0.662420382166,0.63040446304,375,376,226,150,115,260,0.647137150466
3,9,0.613231552163,0.620111731844,0.63925729443,0.593582887701,0.625974025974,0.606557377049,377,374,222,152,136,241,0.616511318242
3,10,0.622691292876,0.618279569892,0.624338624339,0.616621983914,0.623513870542,0.61744966443,378,373,230,143,142,236,0.620505992011
3,11,0.591448931116,0.624242424242,0.667560321716,0.544973544974,0.627204030227,0.581920903955,373,378,206,172,124,249,0.60585885486
3,12,0.621359223301,0.637168141593,0.675461741425,0.58064516129,0.647281921618,0.607594936709,379,372,216,156,123,256,0.628495339547
3,13,0.620603015075,0.628895184136,0.653439153439,0.595174262735,0.636597938144,0.611570247934,378,373,222,151,131,247,0.624500665779
3,14,0.609929078014,0.631097560976,0.68073878628,0.556451612903,0.643391521197,0.591428571429,379,372,207,165,121,258,0.619174434088
3,15,0.6,0.618497109827,0.648,0.56914893617,0.623076923077,0.592797783934,375,376,214,162,132,243,0.608521970706
3,16,0.585956416465,0.58875739645,0.635170603675,0.537837837838,0.609571788413,0.562146892655,381,370,199,171,139,242,0.587217043941
3,17,0.601466992665,0.634502923977,0.66307277628,0.571052631579,0.630769230769,0.601108033241,371,380,217,163,125,246,0.616511318242
3,18,0.586124401914,0.630630630631,0.665760869565,0.548302872063,0.623409669211,0.586592178771,368,383,210,173,123,245,0.60585885486
3,19,0.598039215686,0.632653061224,0.659459459459,0.569553805774,0.627249357326,0.599447513812,370,381,217,164,126,244,0.613848202397
3,20,0.613989637306,0.602739726027,0.620418848168,0.59620596206,0.6171875,0.599455040872,382,369,220,149,145,237,0.608521970706
3,21,0.640102827763,0.629834254144,0.650130548303,0.619565217391,0.645077720207,0.624657534247,383,368,228,140,134,249,0.635153129161
3,22,0.608585858586,0.616901408451,0.63925729443,0.585561497326,0.623544631307,0.600823045267,377,374,219,155,136,241,0.612516644474
3,23,0.611940298507,0.624641833811,0.652519893899,0.582887700535,0.631578947368,0.603042876902,377,374,218,156,131,246,0.617842876165
3,24,0.584577114428,0.598853868195,0.626666666667,0.55585106383,0.604890604891,0.576551724138,375,376,209,167,140,235,0.59121171771
3,25,0.639593908629,0.635854341737,0.659685863874,0.615176151762,0.649484536082,0.625344352617,382,369,227,142,130,252,0.637816245007
3,26,0.6125,0.618233618234,0.646437994723,0.583333333333,0.629011553273,0.600276625173,379,372,217,155,134,245,0.61517976032
3,27,0.571428571429,0.607250755287,0.648648648649,0.527559055118,0.607594936709,0.564606741573,370,381,201,180,130,240,0.587217043941
3,28,0.620347394541,0.635057471264,0.663129973475,0.590909090909,0.641025641026,0.612188365651,377,374,221,153,127,250,0.627163781625
3,29,0.619647355164,0.629943502825,0.652519893899,0.596256684492,0.635658914729,0.612637362637,377,374,223,151,131,246,0.624500665779
3,30,0.615384615385,0.64776119403,0.68449197861,0.575596816976,0.648101265823,0.609550561798,374,377,217,160,118,256,0.62982689747
3,31,0.626315789474,0.614555256065,0.62467191601,0.616216216216,0.625492772668,0.615384615385,381,370,228,142,143,238,0.620505992011
3,32,0.596153846154,0.632835820896,0.66846361186,0.557894736842,0.630241423126,0.593006993007,371,380,212,168,123,248,0.612516644474
3,33,0.642666666667,0.651595744681,0.647849462366,0.646437994723,0.645247657296,0.649006622517,372,379,245,134,131,241,0.647137150466
3,34,0.6484375,0.640326975477,0.653543307087,0.635135135135,0.650980392157,0.637720488467,381,370,235,135,132,249,0.644474034621
3,35,0.619047619048,0.610795454545,0.643229166667,0.58583106267,0.630906768838,0.598052851182,384,367,215,152,137,247,0.61517976032
3,36,0.604010025063,0.630681818182,0.649595687332,0.584210526316,0.625974025974,0.606557377049,371,380,222,158,130,241,0.616511318242
3,37,0.598086124402,0.645645645646,0.679347826087,0.56135770235,0.636132315522,0.600558659218,368,383,215,168,118,250,0.619174434088
3,38,0.596354166667,0.588555858311,0.602631578947,0.582210242588,0.599476439791,0.585365853659,380,371,216,155,151,229,0.592543275632
3,39,0.608478802993,0.617142857143,0.645502645503,0.57908847185,0.626444159178,0.597510373444,378,373,216,157,134,244,0.612516644474
3,40,0.617128463476,0.59604519774,0.631443298969,0.581267217631,0.624203821656,0.588563458856,388,363,211,152,143,245,0.607190412783
3,41,0.634517766497,0.641456582633,0.661375661376,0.613941018767,0.647668393782,0.627397260274,378,373,229,144,128,250,0.637816245007
3,42,0.598039215686,0.588921282799,0.633766233766,0.551912568306,0.615384615385,0.569816643159,385,366,202,164,141,244,0.593874833555
3,43,0.6,0.640483383686,0.679245283019,0.557894736842,0.637168141593,0.596343178622,371,380,212,168,119,252,0.617842876165
3,44,0.5925,0.586894586895,0.620418848168,0.558265582656,0.606138107417,0.572222222222,382,369,206,163,145,237,0.589880159787
3,45,0.612820512821,0.603878116343,0.625654450262,0.590785907859,0.619170984456,0.597260273973,382,369,218,151,143,239,0.608521970706
3,46,0.603406326034,0.65,0.675749318801,0.575520833333,0.637532133676,0.610497237569,367,384,221,163,119,248,0.624500665779
3,47,0.597530864198,0.624277456647,0.650537634409,0.569920844327,0.622908622909,0.595862068966,372,379,216,163,130,242,0.609853528628
3,48,0.590570719603,0.591954022989,0.626315789474,0.55525606469,0.607918263091,0.573018080668,380,371,206,165,142,238,0.59121171771
3,49,0.592682926829,0.633431085044,0.660326086957,0.563968668407,0.624678663239,0.596685082873,368,383,216,167,125,243,0.611185086551
3,50,0.596107055961,0.605882352941,0.646437994723,0.55376344086,0.620253164557,0.578651685393,379,372,206,166,134,245,0.600532623169
3,51,0.592505854801,0.617283950617,0.671087533156,0.534759358289,0.629353233831,0.573065902579,377,374,200,174,124,253,0.603195739015
3,52,0.609452736318,0.613180515759,0.644736842105,0.576819407008,0.626598465473,0.594444444444,380,371,214,157,135,245,0.611185086551
3,53,0.626288659794,0.614325068871,0.634464751958,0.60597826087,0.630350194553,0.610123119015,383,368,223,145,140,243,0.620505992011
3,54,0.649616368286,0.661111111111,0.675531914894,0.634666666667,0.662320730117,0.647619047619,376,375,238,137,122,254,0.655126498003
3,55,0.597014925373,0.624641833811,0.646900269542,0.573684210526,0.620957309185,0.598079561043,371,380,218,162,131,240,0.609853528628
3,56,0.641509433962,0.631578947368,0.62962962963,0.643431635389,0.635514018692,0.637450199203,378,373,240,133,140,238,0.636484687084
3,57,0.64824120603,0.660056657224,0.68253968254,0.624664879357,0.664948453608,0.641873278237,378,373,233,140,120,258,0.65379494008
3,58,0.617346938776,0.618384401114,0.638522427441,0.596774193548,0.62775616083,0.607387140903,379,372,222,150,137,242,0.617842876165
3,59,0.612090680101,0.635593220339,0.653225806452,0.593667546174,0.631989596879,0.613915416098,372,379,225,154,129,243,0.623169107856
3,60,0.626598465473,0.622222222222,0.643044619423,0.605405405405,0.634715025907,0.613698630137,381,370,224,146,136,245,0.624500665779
3,61,0.613466334165,0.64,0.661290322581,0.591029023747,0.636481241915,0.614540466392,372,379,224,155,126,246,0.625832223702
3,62,0.603535353535,0.63661971831,0.649456521739,0.590078328982,0.625654450262,0.612466124661,368,383,226,157,129,239,0.619174434088
3,63,0.614035087719,0.627840909091,0.651595744681,0.589333333333,0.632258064516,0.607977991747,376,375,221,154,131,245,0.620505992011
3,64,0.62077294686,0.66765578635,0.69647696477,0.589005235602,0.656449553001,0.625869262865,369,382,225,157,112,257,0.641810918775
3,65,0.615960099751,0.6,0.638242894057,0.576923076923,0.626903553299,0.588235294118,387,364,210,154,140,247,0.608521970706
3,66,0.638676844784,0.650837988827,0.667553191489,0.621333333333,0.652795838752,0.635743519782,376,375,233,142,125,251,0.644474034621
3,67,0.613756613757,0.603217158177,0.610526315789,0.606469002695,0.612137203166,0.604838709677,380,371,225,146,148,232,0.608521970706
3,68,0.622222222222,0.64450867052,0.672,0.593085106383,0.646153846154,0.617728531856,375,376,223,153,123,252,0.632490013316
3,69,0.599476439791,0.59620596206,0.60582010582,0.58981233244,0.602631578947,0.592991913747,378,373,220,153,149,229,0.597869507324
3,70,0.622327790974,0.627272727273,0.680519480519,0.565573770492,0.650124069479,0.594827586207,385,366,207,159,123,262,0.624500665779
3,71,0.615189873418,0.60393258427,0.6328125,0.58583106267,0.623876765083,0.594744121715,384,367,215,152,141,243,0.609853528628
3,72,0.587053571429,0.646864686469,0.710810810811,0.514435695538,0.643031784841,0.573099415205,370,381,196,185,107,263,0.611185086551
3,73,0.598607888631,0.634375,0.688,0.539893617021,0.640198511166,0.583333333333,375,376,203,173,117,258,0.613848202397
3,74,0.645244215938,0.646408839779,0.662269129288,0.629032258065,0.653645833333,0.637602179837,379,372,234,138,128,251,0.645805592543
3,75,0.605263157895,0.645645645646,0.681940700809,0.565789473684,0.641318124208,0.603085553997,371,380,215,165,118,253,0.623169107856
3,76,0.589805825243,0.619469026549,0.653225806452,0.554089709763,0.619897959184,0.58495821727,372,379,210,169,129,243,0.603195739015
3,77,0.623737373737,0.639436619718,0.658666666667,0.603723404255,0.640726329442,0.621067031464,375,376,227,149,128,247,0.631158455393
3,78,0.596534653465,0.593659942363,0.630890052356,0.558265582656,0.613231552163,0.575418994413,382,369,206,163,141,241,0.595206391478
3,79,0.618138424821,0.64156626506,0.685185185185,0.571045576408,0.649937264743,0.604255319149,378,373,213,160,119,259,0.628495339547
3,80,0.608374384236,0.614492753623,0.65,0.571428571429,0.628498727735,0.59217877095,380,371,212,159,133,247,0.611185086551
3,81,0.604761904762,0.631419939577,0.675531914894,0.557333333333,0.638190954774,0.592067988669,376,375,209,166,122,254,0.616511318242
3,82,0.611650485437,0.654867256637,0.682926829268,0.581151832461,0.645326504481,0.615811373093,369,382,222,160,117,252,0.631158455393
3,83,0.611111111111,0.633802816901,0.650537634409,0.593667546174,0.630208333333,0.613079019074,372,379,225,154,130,242,0.621837549933
3,84,0.603365384615,0.611940298507,0.658792650919,0.554054054054,0.629861982434,0.581560283688,381,370,205,165,130,251,0.607190412783
3,85,0.601485148515,0.64265129683,0.662125340599,0.580729166667,0.630350194553,0.610123119015,367,384,223,161,124,243,0.620505992011
3,86,0.650918635171,0.62972972973,0.644155844156,0.636612021858,0.647519582245,0.633152173913,385,366,233,133,137,248,0.640479360852
3,87,0.616751269036,0.63025210084,0.648,0.598404255319,0.631989596879,0.613915416098,375,376,225,151,132,243,0.623169107856
3,88,0.615763546798,0.623188405797,0.657894736842,0.579514824798,0.636132315522,0.600558659218,380,371,215,156,130,250,0.619174434088
3,89,0.581508515815,0.614705882353,0.645945945946,0.548556430446,0.612035851472,0.579750346741,370,381,209,172,131,239,0.596537949401
3,90,0.613861386139,0.622478386167,0.654353562005,0.58064516129,0.633461047254,0.60083449235,379,372,216,156,131,248,0.617842876165
3,91,0.644607843137,0.66472303207,0.695767195767,0.611260053619,0.669211195929,0.63687150838,378,373,228,145,115,263,0.65379494008
3,92,0.612987012987,0.636612021858,0.639566395664,0.609947643979,0.62599469496,0.622994652406,369,382,233,149,133,236,0.624500665779
3,93,0.595641646489,0.62426035503,0.659517426273,0.558201058201,0.625954198473,0.58938547486,373,378,211,167,127,246,0.608521970706
3,94,0.644562334218,0.644385026738,0.646276595745,0.642666666667,0.645418326693,0.643524699599,376,375,241,134,133,243,0.644474034621
3,95,0.615384615385,0.653731343284,0.688172043011,0.577836411609,0.649746192893,0.613445378151,372,379,219,160,116,256,0.632490013316
3,96,0.579439252336,0.603715170279,0.659574468085,0.52,0.616915422886,0.558739255014,376,375,195,180,128,248,0.589880159787
3,97,0.608585858586,0.622535211268,0.642666666667,0.587765957447,0.625162127108,0.604651162791,375,376,221,155,134,241,0.61517976032
3,98,0.61369193154,0.625730994152,0.662269129288,0.575268817204,0.637055837563,0.59943977591,379,372,214,158,128,251,0.619174434088
3,99,0.616580310881,0.616438356164,0.62962962963,0.603217158177,0.623036649215,0.609756097561,378,373,225,148,140,238,0.616511318242
5,0,0.598591549296,0.643076923077,0.687331536388,0.55,0.639899623588,0.592907801418,371,380,209,171,116,255,0.617842876165
5,1,0.610421836228,0.652298850575,0.67029972752,0.591145833333,0.638961038961,0.620218579235,367,384,227,157,121,246,0.62982689747
5,2,0.620947630923,0.662857142857,0.678474114441,0.604166666667,0.6484375,0.632152588556,367,384,232,152,118,249,0.640479360852
5,3,0.640371229698,0.68125,0.730158730159,0.584450402145,0.682323856613,0.629148629149,378,373,218,155,102,276,0.657789613848
5,4,0.648780487805,0.677419354839,0.707446808511,0.616,0.676844783715,0.645251396648,376,375,231,144,110,266,0.661784287617
5,5,0.630331753555,0.647416413374,0.696335078534,0.577235772358,0.661691542289,0.610315186246,382,369,213,156,116,266,0.637816245007
5,6,0.64857881137,0.651098901099,0.664021164021,0.635388739946,0.656209150327,0.643147896879,378,373,237,136,127,251,0.649800266312
5,7,0.590799031477,0.62426035503,0.657681940701,0.555263157895,0.622448979592,0.587743732591,371,380,211,169,127,244,0.60585885486
5,8,0.598607888631,0.61875,0.678947368421,0.533692722372,0.636251541307,0.573082489146,380,371,198,173,122,258,0.607190412783
5,9,0.647642679901,0.640804597701,0.676165803109,0.61095890411,0.661596958175,0.625525946704,386,365,223,142,125,261,0.644474034621
5,10,0.6325,0.652421652422,0.674666666667,0.609042553191,0.652903225806,0.629986244842,375,376,229,147,122,253,0.641810918775
5,11,0.647058823529,0.641666666667,0.662303664921,0.626016260163,0.654592496766,0.633744855967,382,369,231,138,129,253,0.644474034621
5,12,0.613231552163,0.631284916201,0.646112600536,0.597883597884,0.629242819843,0.614130434783,373,378,226,152,132,241,0.621837549933
5,13,0.6525,0.683760683761,0.701612903226,0.633245382586,0.676165803109,0.657534246575,372,379,240,139,111,261,0.667110519308
5,14,0.630208333333,0.632152588556,0.641909814324,0.620320855615,0.636005256242,0.626180836707,377,374,232,142,135,242,0.631158455393
5,15,0.590277777778,0.652037617555,0.696721311475,0.54025974026,0.639097744361,0.590909090909,366,385,208,177,111,255,0.616511318242
5,16,0.641277641278,0.677325581395,0.701612903226,0.614775725594,0.670089858793,0.644536652835,372,379,233,146,111,261,0.657789613848
5,17,0.624078624079,0.642441860465,0.67374005305,0.590909090909,0.647959183673,0.615598885794,377,374,221,153,123,254,0.632490013316
5,18,0.615925058548,0.638888888889,0.692105263158,0.55795148248,0.651796778191,0.595683453237,380,371,207,164,117,263,0.625832223702
5,19,0.61686746988,0.64880952381,0.68449197861,0.57824933687,0.648922686946,0.611500701262,374,377,218,159,118,256,0.631158455393
5,20,0.612195121951,0.639296187683,0.671122994652,0.57824933687,0.640306122449,0.607242339833,374,377,218,159,123,251,0.624500665779
5,21,0.606205250597,0.635542168675,0.677333333333,0.561170212766,0.639798488665,0.59604519774,375,376,211,165,121,254,0.619174434088
5,22,0.596534653465,0.622478386167,0.647849462366,0.569920844327,0.621134020619,0.595041322314,372,379,216,163,131,241,0.608521970706
5,23,0.604316546763,0.634730538922,0.673796791444,0.562334217507,0.637168141593,0.596343178622,374,377,212,165,122,252,0.617842876165
5,24,0.611494252874,0.655063291139,0.709333333333,0.550531914894,0.656790123457,0.598265895954,375,376,207,169,109,266,0.62982689747
5,25,0.598540145985,0.626470588235,0.659517426273,0.563492063492,0.627551020408,0.593314763231,373,378,213,165,127,246,0.611185086551
5,26,0.577464788732,0.621538461538,0.666666666667,0.528795811518,0.618867924528,0.571428571429,369,382,202,180,123,246,0.596537949401
5,27,0.648717948718,0.653739612188,0.669312169312,0.632707774799,0.658854166667,0.643051771117,378,373,236,137,125,253,0.651131824234
5,28,0.660933660934,0.65988372093,0.69689119171,0.621917808219,0.678436317781,0.640338504937,386,365,227,138,117,269,0.660452729694
5,29,0.61320754717,0.633027522936,0.684210526316,0.55795148248,0.646766169154,0.593123209169,380,371,207,164,120,260,0.621837549933
5,30,0.622276029056,0.644970414201,0.681697612732,0.582887700535,0.650632911392,0.612359550562,377,374,218,156,120,257,0.632490013316
5,31,0.624657534247,0.616580310881,0.606382978723,0.634666666667,0.615384615385,0.625492772668,376,375,238,137,148,228,0.620505992011
5,32,0.635658914729,0.623626373626,0.642297650131,0.616847826087,0.638961038961,0.620218579235,383,368,227,141,137,246,0.62982689747
5,33,0.619277108434,0.636904761905,0.678100263852,0.575268817204,0.647355163728,0.604519774011,379,372,214,158,122,257,0.627163781625
5,34,0.62962962963,0.656069364162,0.681818181818,0.602122015915,0.654685494223,0.627939142462,374,377,227,150,119,255,0.641810918775
5,35,0.62,0.615384615385,0.647519582245,0.586956521739,0.633461047254,0.60083449235,383,368,216,152,135,248,0.617842876165
5,36,0.606714628297,0.649700598802,0.683783783784,0.569553805774,0.642947903431,0.606993006993,370,381,217,164,117,253,0.625832223702
5,37,0.613636363636,0.64308681672,0.708661417323,0.540540540541,0.657734470158,0.587371512482,381,370,200,170,111,270,0.625832223702
5,38,0.616915422886,0.650429799427,0.67027027027,0.595800524934,0.642487046632,0.621917808219,370,381,227,154,122,248,0.632490013316
5,39,0.614318706697,0.679245283019,0.722826086957,0.563968668407,0.664169787765,0.616262482168,368,383,216,167,102,266,0.641810918775
5,40,0.607058823529,0.653374233129,0.695417789757,0.560526315789,0.64824120603,0.603399433428,371,380,213,167,113,258,0.627163781625
5,41,0.638888888889,0.650704225352,0.671087533156,0.617647058824,0.654592496766,0.633744855967,377,374,231,143,124,253,0.644474034621
5,42,0.604597701149,0.629746835443,0.692105263158,0.536388140162,0.645398773006,0.579330422125,380,371,199,172,117,263,0.61517976032
5,43,0.618453865337,0.642857142857,0.664879356568,0.595238095238,0.640826873385,0.618131868132,373,378,225,153,125,248,0.62982689747
5,44,0.633410672854,0.665625,0.718421052632,0.574123989218,0.673242909988,0.616497829233,380,371,213,158,107,273,0.647137150466
5,45,0.622596153846,0.662686567164,0.69623655914,0.585751978892,0.657360406091,0.621848739496,372,379,222,157,113,259,0.640479360852
5,46,0.604166666667,0.626959247649,0.686842105263,0.539083557951,0.642857142857,0.579710144928,380,371,200,171,119,261,0.613848202397
5,47,0.621951219512,0.651026392962,0.681818181818,0.588859416446,0.650510204082,0.618384401114,374,377,222,155,119,255,0.635153129161
5,48,0.614485981308,0.659442724458,0.70509383378,0.563492063492,0.656679151061,0.607703281027,373,378,213,165,110,263,0.633821571238
5,49,0.630071599045,0.680722891566,0.713513513514,0.593175853018,0.669201520913,0.633941093969,370,381,226,155,106,264,0.652463382157
5,50,0.638349514563,0.65191740413,0.690288713911,0.597297297297,0.663303909206,0.62341325811,381,370,221,149,118,263,0.644474034621
5,51,0.632124352332,0.649315068493,0.655913978495,0.625329815303,0.643799472296,0.637096774194,372,379,237,142,128,244,0.640479360852
5,52,0.615577889447,0.634560906516,0.655080213904,0.594164456233,0.634715025907,0.613698630137,374,377,224,153,129,245,0.624500665779
5,53,0.606965174129,0.630372492837,0.654155495979,0.582010582011,0.629677419355,0.60522696011,373,378,220,158,129,244,0.617842876165
5,54,0.615942028986,0.646884272997,0.681818181818,0.57824933687,0.647208121827,0.610644257703,374,377,218,159,119,255,0.62982689747
5,55,0.614657210402,0.65243902439,0.695187165775,0.567639257294,0.652446675031,0.607092198582,374,377,214,163,114,260,0.631158455393
5,56,0.638403990025,0.645714285714,0.673684210526,0.609164420485,0.65556978233,0.626907073509,380,371,226,145,124,256,0.641810918775
5,57,0.632318501171,0.682098765432,0.723860589812,0.584656084656,0.675,0.62962962963,373,378,221,157,103,270,0.65379494008
5,58,0.623831775701,0.671826625387,0.71581769437,0.574074074074,0.666666666667,0.619115549215,373,378,217,161,106,267,0.644474034621
5,59,0.60447761194,0.613180515759,0.642857142857,0.573726541555,0.623076923077,0.592797783934,378,373,214,159,135,243,0.608521970706
5,60,0.60201511335,0.627118644068,0.644204851752,0.584210526316,0.622395833333,0.604904632153,371,380,222,158,132,239,0.613848202397
5,61,0.585882352941,0.601226993865,0.656992084433,0.52688172043,0.619402985075,0.561604584527,379,372,196,176,130,249,0.592543275632
5,62,0.605200945626,0.634146341463,0.68085106383,0.554666666667,0.640801001252,0.591749644381,376,375,208,167,120,256,0.617842876165
5,63,0.612903225806,0.614942528736,0.648293963255,0.578378378378,0.630102040816,0.596100278552,381,370,214,156,134,247,0.613848202397
5,64,0.631578947368,0.644886363636,0.668435013263,0.606951871658,0.649484536082,0.625344352617,377,374,227,147,125,252,0.637816245007
5,65,0.614832535885,0.636636636637,0.679894179894,0.56836461126,0.645728643216,0.600566572238,378,373,212,161,121,257,0.624500665779
5,66,0.624401913876,0.642642642643,0.686842105263,0.576819407008,0.654135338346,0.607954545455,380,371,214,157,119,261,0.632490013316
5,67,0.65903307888,0.675977653631,0.690666666667,0.643617021277,0.674479166667,0.659400544959,375,376,242,134,116,259,0.667110519308
5,68,0.63309352518,0.667664670659,0.704,0.593085106383,0.666666666667,0.628169014085,375,376,223,153,111,264,0.648468708389
5,69,0.611793611794,0.654069767442,0.676630434783,0.587467362924,0.642580645161,0.618982118294,368,383,225,158,119,249,0.631158455393
5,70,0.6225,0.606837606838,0.643410852713,0.585164835165,0.632782719187,0.595804195804,387,364,213,151,138,249,0.61517976032
5,71,0.604265402844,0.632218844985,0.678191489362,0.554666666667,0.639097744361,0.590909090909,376,375,208,167,121,255,0.616511318242
5,72,0.656167979003,0.648648648649,0.657894736842,0.646900269542,0.65703022339,0.647773279352,380,371,240,131,130,250,0.652463382157
5,73,0.63567839196,0.665722379603,0.681940700809,0.618421052632,0.65799739922,0.641200545703,371,380,235,145,118,253,0.649800266312
5,74,0.642297650131,0.635869565217,0.647368421053,0.630727762803,0.644823066841,0.633288227334,380,371,234,137,134,246,0.639147802929
5,75,0.613861386139,0.654178674352,0.673913043478,0.592689295039,0.642487046632,0.621917808219,368,383,227,156,120,248,0.632490013316
5,76,0.611764705882,0.665644171779,0.70460704607,0.568062827225,0.654911838791,0.612994350282,369,382,217,165,109,260,0.635153129161
5,77,0.621749408983,0.640243902439,0.690288713911,0.567567567568,0.654228855721,0.601719197708,381,370,210,160,118,263,0.62982689747
5,78,0.6275,0.646723646724,0.669333333333,0.603723404255,0.647741935484,0.624484181568,375,376,227,149,124,251,0.636484687084
5,79,0.619489559165,0.65625,0.708222811671,0.561497326203,0.660891089109,0.605187319885,377,374,210,164,110,267,0.635153129161
5,80,0.649616368286,0.666666666667,0.679144385027,0.636604774536,0.664052287582,0.651289009498,374,377,240,137,120,254,0.657789613848
5,81,0.621951219512,0.653958944282,0.683646112601,0.589947089947,0.651340996169,0.620305980529,373,378,223,155,118,255,0.636484687084
5,82,0.619164619165,0.630813953488,0.664907651715,0.583333333333,0.641221374046,0.606145251397,379,372,217,155,127,252,0.624500665779
5,83,0.609271523179,0.681208053691,0.743935309973,0.534210526316,0.669902912621,0.598820058997,371,380,203,177,95,276,0.637816245007
5,84,0.626262626263,0.639436619718,0.659574468085,0.605333333333,0.642487046632,0.621917808219,376,375,227,148,128,248,0.632490013316
5,85,0.660194174757,0.681415929204,0.715789473684,0.622641509434,0.686868686869,0.650704225352,380,371,231,140,108,272,0.669773635153
5,86,0.622222222222,0.647398843931,0.673796791444,0.594164456233,0.646983311938,0.619640387275,374,377,224,153,122,252,0.633821571238
5,87,0.655696202532,0.676966292135,0.692513368984,0.63925729443,0.673602080624,0.657571623465,374,377,241,136,115,259,0.665778961385
5,88,0.6,0.643504531722,0.681081081081,0.55905511811,0.637974683544,0.598314606742,370,381,213,168,118,252,0.619174434088
5,89,0.629807692308,0.65671641791,0.694960212202,0.588235294118,0.66078184111,0.620592383639,377,374,220,154,115,262,0.641810918775
5,90,0.637440758294,0.653495440729,0.702349869452,0.584239130435,0.668322981366,0.616929698709,383,368,215,153,114,269,0.644474034621
5,91,0.602352941176,0.644171779141,0.688172043011,0.554089709763,0.642409033877,0.595744680851,372,379,210,169,116,256,0.620505992011
5,92,0.608899297424,0.657407407407,0.700808625337,0.560526315789,0.651629072682,0.605113636364,371,380,213,167,111,260,0.62982689747
5,93,0.636363636364,0.654654654655,0.698162729659,0.589189189189,0.665832290363,0.620199146515,381,370,218,152,115,266,0.644474034621
5,94,0.633663366337,0.668587896254,0.690026954178,0.610526315789,0.66064516129,0.638239339752,371,380,232,148,115,256,0.649800266312
5,95,0.634271099744,0.647222222222,0.661333333333,0.619680851064,0.647519582245,0.633152173913,375,376,233,143,127,248,0.640479360852
5,96,0.622222222222,0.653179190751,0.677419354839,0.596306068602,0.648648648649,0.623448275862,372,379,226,153,120,252,0.636484687084
5,97,0.640776699029,0.666666666667,0.700265251989,0.604278074866,0.669201520913,0.633941093969,377,374,226,148,113,264,0.652463382157
5,98,0.659147869674,0.684659090909,0.70320855615,0.63925729443,0.680465717982,0.661179698217,374,377,241,136,111,263,0.671105193076
5,99,0.606598984772,0.638655462185,0.649456521739,0.595300261097,0.627296587927,0.616216216216,368,383,228,155,129,239,0.621837549933
7,0,0.627160493827,0.670520231214,0.690217391304,0.605744125326,0.657179818887,0.636488340192,368,383,232,151,114,254,0.647137150466
7,1,0.612903225806,0.640804597701,0.663978494624,0.588390501319,0.637419354839,0.613480055021,372,379,223,156,125,247,0.625832223702
7,2,0.606205250597,0.638554216867,0.679144385027,0.562334217507,0.640605296343,0.59802538787,374,377,212,165,120,254,0.620505992011
7,3,0.635897435897,0.653739612188,0.664879356568,0.624338624339,0.650065530799,0.638700947226,373,378,236,142,125,248,0.644474034621
7,4,0.614077669903,0.681415929204,0.700831024931,0.592307692308,0.654592496766,0.633744855967,361,390,231,159,108,253,0.644474034621
7,5,0.586374695864,0.623529411765,0.653116531165,0.55497382199,0.617948717949,0.587257617729,369,382,212,170,128,241,0.603195739015
7,6,0.626903553299,0.655462184874,0.667567567568,0.614173228346,0.646596858639,0.634146341463,370,381,234,147,123,247,0.640479360852
7,7,0.652173913043,0.652818991098,0.697674418605,0.604395604396,0.674157303371,0.627674750357,387,364,220,144,117,270,0.652463382157
7,8,0.634567901235,0.64161849711,0.674540682415,0.6,0.653944020356,0.620111731844,381,370,222,148,124,257,0.637816245007
7,9,0.605769230769,0.641791044776,0.677419354839,0.5672823219,0.639593908629,0.602240896359,372,379,215,164,120,252,0.621837549933
7,10,0.6475,0.666666666667,0.688829787234,0.624,0.667525773196,0.644628099174,376,375,234,141,117,259,0.656458055925
7,11,0.585526315789,0.647457627119,0.719676549865,0.502631578947,0.645707376058,0.565925925926,371,380,191,189,104,267,0.609853528628
7,12,0.597727272727,0.623794212219,0.692105263158,0.522911051213,0.641463414634,0.568914956012,380,371,194,177,117,263,0.608521970706
7,13,0.625304136253,0.638235294118,0.676315789474,0.584905660377,0.649810366625,0.610407876231,380,371,217,154,123,257,0.631158455393
7,14,0.622596153846,0.662686567164,0.69623655914,0.585751978892,0.657360406091,0.621848739496,372,379,222,157,113,259,0.640479360852
7,15,0.618138424821,0.647590361446,0.688829787234,0.573333333333,0.651572327044,0.608203677511,376,375,215,160,117,259,0.631158455393
7,16,0.611241217799,0.641975308642,0.692307692308,0.55614973262,0.649253731343,0.595988538682,377,374,208,166,116,261,0.624500665779
7,17,0.609223300971,0.6401179941,0.672922252011,0.574074074074,0.63949044586,0.60529986053,373,378,217,161,122,251,0.623169107856
7,18,0.647814910026,0.668508287293,0.677419354839,0.638522427441,0.662286465177,0.653171390013,372,379,242,137,120,252,0.657789613848
7,19,0.642335766423,0.664705882353,0.698412698413,0.605898123324,0.669201520913,0.633941093969,378,373,226,147,114,264,0.652463382157
7,20,0.611386138614,0.636887608069,0.662198391421,0.584656084656,0.635778635779,0.609655172414,373,378,221,157,126,247,0.623169107856
7,21,0.652956298201,0.646408839779,0.664921465969,0.634146341463,0.658884565499,0.640218878249,382,369,234,135,128,254,0.649800266312
7,22,0.624703087886,0.639393939394,0.688481675393,0.571815718157,0.65504358655,0.603719599428,382,369,211,158,119,263,0.631158455393
7,23,0.609571788413,0.624293785311,0.645333333333,0.587765957447,0.626943005181,0.605479452055,375,376,221,155,133,242,0.616511318242
7,24,0.631043256997,0.634078212291,0.654353562005,0.610215053763,0.642487046632,0.621917808219,379,372,227,145,131,248,0.632490013316
7,25,0.608200455581,0.685897435897,0.731506849315,0.554404145078,0.664179104478,0.613180515759,365,386,214,172,98,267,0.640479360852
7,26,0.644607843137,0.65889212828,0.692105263158,0.609164420485,0.667512690355,0.633053221289,380,371,226,145,117,263,0.651131824234
7,27,0.636132315522,0.634078212291,0.656167979003,0.613513513514,0.645994832041,0.623626373626,381,370,227,143,131,250,0.635153129161
7,28,0.6276849642,0.656626506024,0.697612732095,0.582887700535,0.660804020101,0.617563739377,377,374,218,156,114,263,0.640479360852
7,29,0.608076009501,0.663636363636,0.697547683924,0.5703125,0.649746192893,0.613445378151,367,384,219,165,111,256,0.632490013316
7,30,0.609929078014,0.661585365854,0.69918699187,0.568062827225,0.651515151515,0.611267605634,369,382,217,165,111,258,0.632490013316
7,31,0.623471882641,0.637426900585,0.672823218997,0.586021505376,0.647208121827,0.610644257703,379,372,218,154,124,255,0.62982689747
7,32,0.597315436242,0.671052631579,0.727520435967,0.53125,0.65601965602,0.593023255814,367,384,204,180,100,267,0.627163781625
7,33,0.625310173697,0.620689655172,0.65625,0.588555858311,0.64040660737,0.604195804196,384,367,216,151,132,252,0.623169107856
7,34,0.609498680739,0.615591397849,0.617647058824,0.607427055703,0.613545816733,0.611481975968,374,377,229,148,143,231,0.612516644474
7,35,0.605633802817,0.633846153846,0.684350132626,0.550802139037,0.642590286426,0.589413447783,377,374,206,168,119,258,0.617842876165
7,36,0.622448979592,0.635097493036,0.650666666667,0.606382978723,0.636245110821,0.620408163265,375,376,228,148,131,244,0.628495339547
7,37,0.650130548303,0.625,0.643410852713,0.631868131868,0.646753246753,0.628415300546,387,364,230,134,138,249,0.637816245007
7,38,0.618705035971,0.646706586826,0.686170212766,0.576,0.650693568726,0.609308885755,376,375,216,159,118,258,0.631158455393
7,39,0.64578313253,0.672619047619,0.708994708995,0.605898123324,0.675914249685,0.637517630465,378,373,226,147,110,268,0.657789613848
7,40,0.641089108911,0.657060518732,0.685185185185,0.611260053619,0.662404092072,0.633333333333,378,373,228,145,119,259,0.648468708389
7,41,0.633004926108,0.649275362319,0.679894179894,0.600536193029,0.655612244898,0.623955431755,378,373,224,149,121,257,0.640479360852
7,42,0.607476635514,0.640866873065,0.691489361702,0.552,0.646766169154,0.593123209169,376,375,207,168,116,260,0.621837549933
7,43,0.65963060686,0.674731182796,0.673854447439,0.660526315789,0.666666666667,0.667553191489,371,380,251,129,121,250,0.667110519308
7,44,0.603644646925,0.641025641026,0.702917771883,0.534759358289,0.649509803922,0.583090379009,377,374,200,174,112,265,0.619174434088
7,45,0.630733944954,0.698412698413,0.743243243243,0.577427821522,0.682382133995,0.632183908046,370,381,220,161,95,275,0.659121171771
7,46,0.627249357326,0.649171270718,0.657681940701,0.618421052632,0.642105263158,0.633423180593,371,380,235,145,127,244,0.637816245007
7,47,0.641025641026,0.650969529086,0.664893617021,0.626666666667,0.65274151436,0.638586956522,376,375,235,140,126,250,0.645805592543
7,48,0.598173515982,0.654952076677,0.708108108108,0.538057742782,0.648514851485,0.590778097983,370,381,205,176,108,262,0.621837549933
7,49,0.628361858191,0.654970760234,0.685333333333,0.595744680851,0.655612244898,0.623955431755,375,376,224,152,118,257,0.640479360852
7,50,0.624113475177,0.637195121951,0.689295039164,0.567934782609,0.655086848635,0.600574712644,383,368,209,159,119,264,0.62982689747
7,51,0.626535626536,0.65988372093,0.685483870968,0.598944591029,0.654685494223,0.627939142462,372,379,227,152,117,255,0.641810918775
7,52,0.6425,0.655270655271,0.679894179894,0.616621983914,0.660668380463,0.635359116022,378,373,230,143,121,257,0.648468708389
7,53,0.646080760095,0.675757575758,0.717678100264,0.599462365591,0.68,0.635327635328,379,372,223,149,107,272,0.659121171771
7,54,0.612590799031,0.633136094675,0.671087533156,0.572192513369,0.640506329114,0.601123595506,377,374,214,160,124,253,0.621837549933
7,55,0.614832535885,0.645645645646,0.685333333333,0.571808510638,0.648171500631,0.606488011283,375,376,215,161,118,257,0.628495339547
7,56,0.659090909091,0.647887323944,0.676165803109,0.630136986301,0.667519181586,0.638888888889,386,365,230,135,125,261,0.65379494008
7,57,0.616504854369,0.648967551622,0.680965147453,0.582010582011,0.647133757962,0.613668061367,373,378,220,158,119,254,0.631158455393
7,58,0.649874055416,0.675141242938,0.691689008043,0.632275132275,0.67012987013,0.653005464481,373,378,239,139,115,258,0.661784287617
7,59,0.610451306413,0.651515151515,0.690860215054,0.5672823219,0.648171500631,0.606488011283,372,379,215,164,115,257,0.628495339547
7,60,0.64,0.666666666667,0.686327077748,0.619047619048,0.662354463131,0.641975308642,373,378,234,144,117,256,0.652463382157
7,61,0.604368932039,0.634218289086,0.667560321716,0.568783068783,0.634394904459,0.599721059972,373,378,215,163,124,249,0.617842876165
7,62,0.622596153846,0.653731343284,0.690666666667,0.582446808511,0.654867256637,0.616033755274,375,376,219,157,116,259,0.636484687084
7,63,0.645569620253,0.660112359551,0.678191489362,0.626666666667,0.661478599222,0.642954856361,376,375,235,140,121,255,0.652463382157
7,64,0.67018469657,0.631720430108,0.649616368286,0.652777777778,0.65974025974,0.642076502732,391,360,235,125,137,254,0.651131824234
7,65,0.626477541371,0.658536585366,0.702917771883,0.577540106952,0.6625,0.615384615385,377,374,216,158,112,265,0.640479360852
7,66,0.637931034483,0.655072463768,0.685185185185,0.605898123324,0.660714285714,0.629526462396,378,373,226,147,119,259,0.645805592543
7,67,0.6,0.61797752809,0.635388739946,0.582010582011,0.6171875,0.599455040872,373,378,220,158,136,237,0.608521970706
7,68,0.607058823529,0.662576687117,0.701086956522,0.563968668407,0.650693568726,0.609308885755,368,383,216,167,110,258,0.631158455393
7,69,0.625310173697,0.640804597701,0.668435013263,0.596256684492,0.646153846154,0.617728531856,377,374,223,151,125,252,0.632490013316
7,70,0.609004739336,0.644376899696,0.687165775401,0.562334217507,0.645728643216,0.600566572238,374,377,212,165,117,257,0.624500665779
7,71,0.650246305419,0.678260869565,0.704,0.622340425532,0.676056338028,0.649098474341,375,376,234,142,111,264,0.663115845539
7,72,0.631578947368,0.636363636364,0.663157894737,0.603773584906,0.646983311938,0.619640387275,380,371,224,147,128,252,0.633821571238
7,73,0.604316546763,0.655688622754,0.686648501362,0.5703125,0.642857142857,0.610027855153,367,384,219,165,115,252,0.627163781625
7,74,0.63,0.635327635328,0.663157894737,0.601078167116,0.646153846154,0.617728531856,380,371,223,148,128,252,0.632490013316
7,75,0.67277486911,0.661246612466,0.67277486911,0.661246612466,0.67277486911,0.661246612466,382,369,244,125,125,257,0.667110519308
7,76,0.643617021277,0.656,0.652291105121,0.647368421053,0.647925033467,0.651655629139,371,380,246,134,129,242,0.649800266312
7,77,0.6325,0.638176638177,0.665789473684,0.603773584906,0.648717948718,0.620498614958,380,371,224,147,127,253,0.635153129161
7,78,0.609523809524,0.652567975831,0.690026954178,0.568421052632,0.647281921618,0.607594936709,371,380,216,164,115,256,0.628495339547
7,79,0.627737226277,0.661764705882,0.691689008043,0.595238095238,0.658163265306,0.626740947075,373,378,225,153,115,258,0.643142476698
7,80,0.597619047619,0.61329305136,0.662269129288,0.545698924731,0.628285356696,0.577524893314,379,372,203,169,128,251,0.604527296937
7,81,0.663212435233,0.646575342466,0.664935064935,0.644808743169,0.664072632944,0.645690834473,385,366,236,130,129,256,0.655126498003
7,82,0.611904761905,0.63746223565,0.681697612732,0.564171122995,0.644918444166,0.598581560284,377,374,211,163,120,257,0.623169107856
7,83,0.638888888889,0.622535211268,0.653746770026,0.607142857143,0.646232439336,0.614742698192,387,364,221,143,134,253,0.631158455393
7,84,0.610421836228,0.646551724138,0.666666666667,0.589005235602,0.637305699482,0.616438356164,369,382,225,157,123,246,0.627163781625
7,85,0.602352941176,0.644171779141,0.688172043011,0.554089709763,0.642409033877,0.595744680851,372,379,210,169,116,256,0.620505992011
7,86,0.637037037037,0.667630057803,0.691689008043,0.611111111111,0.66323907455,0.638121546961,373,378,231,147,115,258,0.651131824234
7,87,0.647058823529,0.65306122449,0.689295039164,0.608695652174,0.667509481669,0.630098452883,383,368,224,144,119,264,0.649800266312
7,88,0.625,0.653731343284,0.691489361702,0.584,0.656565656566,0.616901408451,376,375,219,156,116,260,0.637816245007
7,89,0.620930232558,0.672897196262,0.717741935484,0.569920844327,0.665835411471,0.617142857143,372,379,216,163,105,267,0.643142476698
7,90,0.617948717949,0.645429362881,0.653116531165,0.609947643979,0.635046113307,0.627187079408,369,382,233,149,128,241,0.631158455393
7,91,0.629353233831,0.638968481375,0.667546174142,0.599462365591,0.647887323944,0.618585298197,379,372,223,149,126,253,0.633821571238
7,92,0.618055555556,0.639498432602,0.698952879581,0.552845528455,0.65601965602,0.593023255814,382,369,204,165,115,267,0.627163781625
7,93,0.588764044944,0.676470588235,0.725761772853,0.530769230769,0.650124069479,0.594827586207,361,390,207,183,99,262,0.624500665779
7,94,0.638694638695,0.686335403727,0.730666666667,0.587765957447,0.681592039801,0.63323782235,375,376,221,155,101,274,0.659121171771
7,95,0.622222222222,0.661849710983,0.682926829268,0.599476439791,0.651162790698,0.629120879121,369,382,229,153,117,252,0.640479360852
7,96,0.631707317073,0.671554252199,0.698113207547,0.602631578947,0.663252240717,0.635228848821,371,380,229,151,112,259,0.649800266312
7,97,0.62077294686,0.66765578635,0.69647696477,0.589005235602,0.656449553001,0.625869262865,369,382,225,157,112,257,0.641810918775
7,98,0.604368932039,0.637168141593,0.66935483871,0.569920844327,0.635204081633,0.601671309192,372,379,216,163,123,249,0.619174434088
7,99,0.619047619048,0.643504531722,0.687830687831,0.571045576408,0.651629072682,0.605113636364,378,373,213,160,118,260,0.62982689747
9,0,0.612345679012,0.630057803468,0.659574468085,0.581333333333,0.635083226633,0.604715672677,376,375,218,157,128,248,0.620505992011
9,1,0.589977220957,0.625,0.688829787234,0.52,0.635582822086,0.56768558952,376,375,195,180,117,259,0.604527296937
9,2,0.61214953271,0.668730650155,0.710027100271,0.565445026178,0.657465495609,0.612765957447,369,382,216,166,107,262,0.636484687084
9,3,0.624078624079,0.645348837209,0.675531914894,0.592,0.648786717752,0.61752433936,376,375,222,153,122,254,0.633821571238
9,4,0.651629072682,0.670454545455,0.691489361702,0.629333333333,0.670967741935,0.6492434663,376,375,236,139,116,260,0.660452729694
9,5,0.635491606715,0.673652694611,0.708556149733,0.596816976127,0.670037926675,0.632911392405,374,377,225,152,109,265,0.652463382157
9,6,0.615566037736,0.65749235474,0.699731903485,0.568783068783,0.65495608532,0.609929078014,373,378,215,163,112,261,0.633821571238
9,7,0.634032634033,0.658385093168,0.712041884817,0.574525745257,0.670776818742,0.613603473227,382,369,212,157,110,272,0.644474034621
9,8,0.629268292683,0.651026392962,0.684350132626,0.593582887701,0.655654383736,0.620979020979,377,374,222,152,119,258,0.639147802929
9,9,0.629441624365,0.658263305322,0.67027027027,0.616797900262,0.649214659686,0.636856368564,370,381,235,146,122,248,0.643142476698
9,10,0.649553571429,0.722772277228,0.776,0.582446808511,0.707168894289,0.645066273932,375,376,219,157,84,291,0.679094540613
9,11,0.639303482587,0.656160458453,0.681697612732,0.612299465241,0.659820282413,0.63347164592,377,374,229,145,120,257,0.647137150466
9,12,0.598152424942,0.64465408805,0.69623655914,0.540897097625,0.64347826087,0.588235294118,372,379,205,174,113,259,0.617842876165
9,13,0.629976580796,0.675925925926,0.719251336898,0.580901856764,0.671660424469,0.62482168331,374,377,219,158,105,269,0.649800266312
9,14,0.64039408867,0.617391304348,0.663265306122,0.593314763231,0.651629072682,0.605113636364,392,359,213,146,132,260,0.62982689747
9,15,0.661538461538,0.656509695291,0.675392670157,0.642276422764,0.668393782383,0.649315068493,382,369,237,132,124,258,0.659121171771
9,16,0.629716981132,0.669724770642,0.712,0.582446808511,0.668335419274,0.623044096728,375,376,219,157,108,267,0.647137150466
9,17,0.615960099751,0.64,0.662198391421,0.592592592593,0.638242894057,0.615384615385,373,378,224,154,126,247,0.627163781625
9,18,0.615751789976,0.650602409639,0.689839572193,0.572944297082,0.650693568726,0.609308885755,374,377,216,161,116,258,0.631158455393
9,19,0.621553884712,0.622159090909,0.650918635171,0.591891891892,0.635897435897,0.606648199446,381,370,219,151,133,248,0.621837549933
9,20,0.593824228029,0.657575757576,0.68870523416,0.559278350515,0.637755102041,0.604456824513,363,388,217,171,113,250,0.621837549933
9,21,0.614634146341,0.636363636364,0.670212765957,0.578666666667,0.641221374046,0.606145251397,376,375,217,158,124,252,0.624500665779
9,22,0.658097686375,0.657458563536,0.673684210526,0.641509433962,0.665799739922,0.649386084584,380,371,238,133,124,256,0.657789613848
9,23,0.607142857143,0.643504531722,0.683646112601,0.563492063492,0.643127364439,0.600846262341,373,378,213,165,118,255,0.623169107856
9,24,0.624113475177,0.667682926829,0.707774798928,0.579365079365,0.663316582915,0.620396600567,373,378,219,159,109,264,0.643142476698
9,25,0.616438356164,0.648562300319,0.710526315789,0.547169811321,0.660146699267,0.593567251462,380,371,203,168,110,270,0.62982689747
9,26,0.627118644068,0.633136094675,0.676240208877,0.58152173913,0.650753768844,0.606232294618,383,368,214,154,124,259,0.62982689747
9,27,0.655086848635,0.663793103448,0.692913385827,0.624324324324,0.673469387755,0.643454038997,381,370,231,139,117,264,0.659121171771
9,28,0.613861386139,0.619596541787,0.652631578947,0.579514824798,0.632653061224,0.598885793872,380,371,215,156,132,248,0.616511318242
9,29,0.595936794582,0.668831168831,0.72131147541,0.535064935065,0.652657601978,0.594516594517,366,385,206,179,102,264,0.625832223702
9,30,0.634844868735,0.650602409639,0.696335078534,0.585365853659,0.664169787765,0.616262482168,382,369,216,153,116,266,0.641810918775
9,31,0.634615384615,0.662686567164,0.700265251989,0.593582887701,0.665825977301,0.626234132581,377,374,222,152,113,264,0.647137150466
9,32,0.640371229698,0.7,0.741935483871,0.591029023747,0.687422166874,0.640915593705,372,379,224,155,96,276,0.665778961385
9,33,0.612980769231,0.644776119403,0.681818181818,0.572944297082,0.645569620253,0.606741573034,374,377,216,161,119,255,0.627163781625
9,34,0.630653266332,0.643059490085,0.665782493369,0.606951871658,0.647741935484,0.624484181568,377,374,227,147,126,251,0.636484687084
9,35,0.641148325359,0.651651651652,0.697916666667,0.591280653951,0.668329177057,0.62,384,367,217,150,116,268,0.645805592543
9,36,0.627791563275,0.672413793103,0.689373297003,0.609375,0.657142857143,0.639344262295,367,384,234,150,114,253,0.648468708389
9,37,0.594907407407,0.66144200627,0.704109589041,0.546632124352,0.644918444166,0.598581560284,365,386,211,175,108,257,0.623169107856
9,38,0.625850340136,0.696774193548,0.745945945946,0.566929133858,0.680641183724,0.62518089725,370,381,216,165,94,276,0.655126498003
9,39,0.645476772616,0.672514619883,0.702127659574,0.613333333333,0.672611464968,0.641562064156,376,375,230,145,112,264,0.657789613848
9,40,0.626344086022,0.654353562005,0.64010989011,0.640826873385,0.633152173913,0.647519582245,364,387,248,139,131,233,0.640479360852
9,41,0.604422604423,0.633720930233,0.661290322581,0.575197889182,0.631578947368,0.603042876902,372,379,218,161,126,246,0.617842876165
9,42,0.641414141414,0.653521126761,0.67374005305,0.620320855615,0.657179818887,0.636488340192,377,374,232,142,123,254,0.647137150466
9,43,0.628571428571,0.649546827795,0.694736842105,0.579514824798,0.66,0.612535612536,380,371,215,156,116,264,0.637816245007
9,44,0.605504587156,0.657142857143,0.709677419355,0.54617414248,0.653465346535,0.596541786744,372,379,207,172,108,264,0.627163781625
9,45,0.61938534279,0.628048780488,0.682291666667,0.561307901907,0.649318463445,0.592805755396,384,367,206,161,122,262,0.623169107856
9,46,0.645333333333,0.632978723404,0.636842105263,0.641509433962,0.641059602649,0.637215528782,380,371,238,133,138,242,0.639147802929
9,47,0.630484988453,0.650943396226,0.7109375,0.564032697548,0.668298653611,0.604379562044,384,367,207,160,111,273,0.639147802929
9,48,0.62037037037,0.667711598746,0.716577540107,0.564986737401,0.665012406948,0.612068965517,374,377,213,164,106,268,0.640479360852
9,49,0.61252900232,0.634375,0.692913385827,0.548648648649,0.650246305419,0.588405797101,381,370,203,167,117,264,0.621837549933
9,50,0.647058823529,0.633952254642,0.636842105263,0.644204851752,0.641909814324,0.639037433155,380,371,239,132,138,242,0.640479360852
9,51,0.600461893764,0.666666666667,0.710382513661,0.550649350649,0.650813516896,0.603129445235,366,385,212,173,106,260,0.628495339547
9,52,0.622009569378,0.627627627628,0.677083333333,0.569482288828,0.648379052369,0.597142857143,384,367,209,158,124,260,0.624500665779
9,53,0.608272506083,0.647058823529,0.675675675676,0.577427821522,0.640204865557,0.610263522885,370,381,220,161,120,250,0.625832223702
9,54,0.606132075472,0.636085626911,0.683510638298,0.554666666667,0.6425,0.592592592593,376,375,208,167,119,257,0.619174434088
9,55,0.614117647059,0.650306748466,0.696,0.563829787234,0.6525,0.603988603989,375,376,212,164,114,261,0.62982689747
9,56,0.614849187935,0.66875,0.714285714286,0.563157894737,0.660847880299,0.611428571429,371,380,214,166,106,265,0.637816245007
9,57,0.643391521197,0.637142857143,0.67012987013,0.609289617486,0.656488549618,0.622905027933,385,366,223,143,127,258,0.640479360852
9,58,0.632352941176,0.65889212828,0.688,0.601063829787,0.659003831418,0.628650904033,375,376,226,150,117,258,0.644474034621
9,59,0.622549019608,0.629737609329,0.666666666667,0.583783783784,0.643852978454,0.605890603086,381,370,216,154,127,254,0.625832223702
9,60,0.60088691796,0.646666666667,0.718832891247,0.51871657754,0.654589371981,0.575667655786,377,374,194,180,106,271,0.619174434088
9,61,0.602380952381,0.646525679758,0.683783783784,0.561679790026,0.640506329114,0.601123595506,370,381,214,167,117,253,0.621837549933
9,62,0.626262626263,0.647887323944,0.664879356568,0.608465608466,0.644993498049,0.6275579809,373,378,230,148,125,248,0.636484687084
9,63,0.648192771084,0.669642857143,0.707894736842,0.606469002695,0.676729559748,0.636492220651,380,371,225,146,111,269,0.657789613848
9,64,0.645885286783,0.648571428571,0.678010471204,0.615176151762,0.661558109834,0.631432545202,382,369,227,142,123,259,0.647137150466
9,65,0.638403990025,0.634285714286,0.666666666667,0.604904632153,0.652229299363,0.619246861925,384,367,222,145,128,256,0.636484687084
9,66,0.621428571429,0.652567975831,0.69414893617,0.576,0.655778894472,0.611898016997,376,375,216,159,115,261,0.635153129161
9,67,0.603773584906,0.62996941896,0.679045092838,0.550802139037,0.639200998752,0.587731811698,377,374,206,168,121,256,0.61517976032
9,68,0.619158878505,0.69040247678,0.72602739726,0.577720207254,0.668348045397,0.629055007052,365,386,223,163,100,265,0.649800266312
9,69,0.609452736318,0.63323782235,0.656836461126,0.584656084656,0.632258064516,0.607977991747,373,378,221,157,128,245,0.620505992011
9,70,0.610208816705,0.64375,0.697612732095,0.550802139037,0.65099009901,0.593659942363,377,374,206,168,114,263,0.624500665779
9,71,0.606557377049,0.638888888889,0.688829787234,0.552,0.645080946451,0.592274678112,376,375,207,168,117,259,0.620505992011
9,72,0.645728643216,0.657223796034,0.679894179894,0.621983914209,0.662371134021,0.6391184573,378,373,232,141,121,257,0.651131824234
9,73,0.633971291866,0.654654654655,0.697368421053,0.587601078167,0.664160401003,0.619318181818,380,371,218,153,115,265,0.643142476698
9,74,0.618090452261,0.637393767705,0.657754010695,0.596816976127,0.637305699482,0.616438356164,374,377,225,152,128,246,0.627163781625
9,75,0.618390804598,0.655063291139,0.71164021164,0.554959785523,0.661746617466,0.600870827286,378,373,207,166,109,269,0.633821571238
9,76,0.633569739953,0.649390243902,0.699738903394,0.578804347826,0.665012406948,0.612068965517,383,368,213,155,115,268,0.640479360852
9,77,0.642512077295,0.655786350148,0.696335078534,0.59891598916,0.668341708543,0.626062322946,382,369,221,148,116,266,0.648468708389
9,78,0.651282051282,0.626038781163,0.652956298201,0.624309392265,0.652118100128,0.625172890733,389,362,226,136,135,254,0.639147802929
9,79,0.633906633907,0.654069767442,0.684350132626,0.601604278075,0.658163265306,0.626740947075,377,374,225,149,119,258,0.643142476698
9,80,0.616368286445,0.633333333333,0.646112600536,0.603174603175,0.630890052356,0.617886178862,373,378,228,150,132,241,0.624500665779
9,81,0.620437956204,0.644117647059,0.678191489362,0.584,0.648030495553,0.612587412587,376,375,219,156,121,255,0.631158455393
9,82,0.613953488372,0.644859813084,0.698412698413,0.554959785523,0.653465346535,0.596541786744,378,373,207,166,114,264,0.627163781625
9,83,0.613793103448,0.648734177215,0.706349206349,0.549597855228,0.656826568266,0.595065312046,378,373,205,168,111,267,0.628495339547
9,84,0.631707317073,0.66275659824,0.692513368984,0.599469496021,0.660714285714,0.629526462396,374,377,226,151,115,259,0.645805592543
9,85,0.586956521739,0.649484536082,0.725806451613,0.498680738786,0.649038461538,0.564179104478,372,379,189,190,102,270,0.611185086551
9,86,0.611241217799,0.635802469136,0.688654353562,0.55376344086,0.647642679901,0.591954022989,379,372,206,166,118,261,0.621837549933
9,87,0.641975308642,0.653179190751,0.684210526316,0.609164420485,0.662420382166,0.63040446304,380,371,226,145,120,260,0.647137150466
9,88,0.627296587927,0.6,0.617571059432,0.60989010989,0.622395833333,0.604904632153,387,364,222,142,148,239,0.613848202397
9,89,0.634844868735,0.66265060241,0.703703703704,0.58981233244,0.667503136763,0.624113475177,378,373,220,153,112,266,0.647137150466
9,90,0.615942028986,0.643916913947,0.68,0.577127659574,0.6463878327,0.608695652174,375,376,217,159,120,255,0.628495339547
9,91,0.64406779661,0.653846153846,0.694516971279,0.600543478261,0.668341708543,0.626062322946,383,368,221,147,117,266,0.648468708389
9,92,0.594847775176,0.648148148148,0.690217391304,0.548302872063,0.638993710692,0.594059405941,368,383,210,173,114,254,0.617842876165
9,93,0.593824228029,0.615151515152,0.663129973475,0.542780748663,0.62656641604,0.576704545455,377,374,203,171,127,250,0.603195739015
9,94,0.621176470588,0.671779141104,0.711590296496,0.576315789474,0.663316582915,0.620396600567,371,380,219,161,107,264,0.643142476698
9,95,0.631325301205,0.639880952381,0.68407310705,0.584239130435,0.65664160401,0.610795454545,383,368,215,153,121,262,0.635153129161
9,96,0.625304136253,0.655882352941,0.687165775401,0.59151193634,0.654777070064,0.622036262204,374,377,223,154,117,257,0.639147802929
9,97,0.616504854369,0.660766961652,0.688346883469,0.586387434555,0.650448143406,0.621359223301,369,382,224,158,115,254,0.636484687084
9,98,0.614427860697,0.638968481375,0.662198391421,0.589947089947,0.637419354839,0.613480055021,373,378,223,155,126,247,0.625832223702
9,99,0.601466992665,0.652046783626,0.67397260274,0.577720207254,0.635658914729,0.612637362637,365,386,223,163,119,246,0.624500665779
11,0,0.640776699029,0.672566371681,0.704,0.606382978723,0.670902160102,0.637762237762,375,376,228,148,111,264,0.655126498003
11,1,0.641860465116,0.688473520249,0.734042553191,0.589333333333,0.684863523573,0.635057471264,376,375,221,154,100,276,0.661784287617
11,2,0.624423963134,0.649842271293,0.70942408377,0.558265582656,0.664215686275,0.600583090379,382,369,206,163,111,271,0.635153129161
11,3,0.642180094787,0.693009118541,0.728494623656,0.601583113456,0.682619647355,0.64406779661,372,379,228,151,101,271,0.664447403462
11,4,0.606481481481,0.633228840125,0.691292875989,0.543010752688,0.646115906289,0.584659913169,379,372,202,170,117,262,0.617842876165
11,5,0.607981220657,0.649230769231,0.69436997319,0.558201058201,0.648310387985,0.600284495021,373,378,211,167,114,259,0.625832223702
11,6,0.634085213033,0.647727272727,0.671087533156,0.609625668449,0.65206185567,0.628099173554,377,374,228,146,124,253,0.640479360852
11,7,0.627078384798,0.651515151515,0.696569920844,0.577956989247,0.66,0.612535612536,379,372,215,157,115,264,0.637816245007
11,8,0.621890547264,0.630372492837,0.65963060686,0.591397849462,0.640204865557,0.610263522885,379,372,220,152,129,250,0.625832223702
11,9,0.615384615385,0.68284789644,0.735135135135,0.553805774278,0.669950738916,0.611594202899,370,381,211,170,98,272,0.643142476698
11,10,0.645994832041,0.645604395604,0.65963060686,0.631720430108,0.65274151436,0.638586956522,379,372,235,137,129,250,0.645805592543
11,11,0.628841607565,0.658536585366,0.703703703704,0.57908847185,0.664169787765,0.616262482168,378,373,216,157,112,266,0.641810918775
11,12,0.609819121447,0.601648351648,0.619422572178,0.591891891892,0.614583333333,0.596730245232,381,370,219,151,145,236,0.60585885486
11,13,0.6484375,0.66485013624,0.66935483871,0.643799472296,0.65873015873,0.654155495979,372,379,244,135,123,249,0.656458055925
11,14,0.605140186916,0.640866873065,0.690666666667,0.550531914894,0.645080946451,0.592274678112,375,376,207,169,116,259,0.620505992011
11,15,0.620098039216,0.661807580175,0.685636856369,0.594240837696,0.651222651223,0.626206896552,369,382,227,155,116,253,0.639147802929
11,16,0.64953271028,0.681114551084,0.729658792651,0.594594594595,0.687268232386,0.634920634921,381,370,220,150,103,278,0.663115845539
11,17,0.631455399061,0.658461538462,0.707894736842,0.576819407008,0.667493796526,0.614942528736,380,371,214,157,111,269,0.643142476698
11,18,0.592342342342,0.631921824104,0.699468085106,0.517333333333,0.641463414634,0.568914956012,376,375,194,181,113,263,0.608521970706
11,19,0.621890547264,0.636103151862,0.663129973475,0.593582887701,0.641848523748,0.614107883817,377,374,222,152,127,250,0.628495339547
11,20,0.633838383838,0.642253521127,0.664021164021,0.611260053619,0.64857881137,0.626373626374,378,373,228,145,127,251,0.637816245007
11,21,0.600461893764,0.657232704403,0.70460704607,0.547120418848,0.648379052369,0.597142857143,369,382,209,173,109,260,0.624500665779
11,22,0.588636363636,0.665594855305,0.71349862259,0.533505154639,0.645080946451,0.592274678112,363,388,207,181,104,259,0.620505992011
11,23,0.618390804598,0.674050632911,0.72311827957,0.562005277045,0.666666666667,0.612949640288,372,379,213,166,103,269,0.641810918775
11,24,0.658536585366,0.689149560117,0.718085106383,0.626666666667,0.687022900763,0.656424581006,376,375,235,140,106,270,0.672436750999
11,25,0.612745098039,0.644314868805,0.672043010753,0.583113456464,0.641025641026,0.612188365651,372,379,221,158,122,250,0.627163781625
11,26,0.626477541371,0.667682926829,0.708556149733,0.580901856764,0.664993726474,0.621276595745,374,377,219,158,109,265,0.644474034621
11,27,0.611510791367,0.652694610778,0.687331536388,0.573684210526,0.647208121827,0.610644257703,371,380,218,162,116,255,0.62982689747
11,28,0.630272952854,0.649425287356,0.675531914894,0.602666666667,0.652118100128,0.625172890733,376,375,226,149,122,254,0.639147802929
11,29,0.639705882353,0.65889212828,0.690476190476,0.605898123324,0.664122137405,0.631284916201,378,373,226,147,117,261,0.648468708389
11,30,0.610978520286,0.650602409639,0.688172043011,0.569920844327,0.647281921618,0.607594936709,372,379,216,163,116,256,0.628495339547
11,31,0.636138613861,0.648414985591,0.678100263852,0.604838709677,0.656449553001,0.625869262865,379,372,225,147,122,257,0.641810918775
11,32,0.612385321101,0.647619047619,0.706349206349,0.54691689008,0.65601965602,0.593023255814,378,373,204,169,111,267,0.627163781625
11,33,0.645728643216,0.657223796034,0.679894179894,0.621983914209,0.662371134021,0.6391184573,378,373,232,141,121,257,0.651131824234
11,34,0.625,0.66472303207,0.689189189189,0.59842519685,0.655526992288,0.629834254144,370,381,228,153,115,255,0.643142476698
11,35,0.641604010025,0.647727272727,0.673684210526,0.614555256065,0.657252888318,0.630705394191,380,371,228,143,124,256,0.644474034621
11,36,0.625,0.688073394495,0.722070844687,0.5859375,0.670037926675,0.632911392405,367,384,225,159,102,265,0.652463382157
11,37,0.639303482587,0.656160458453,0.681697612732,0.612299465241,0.659820282413,0.63347164592,377,374,229,145,120,257,0.647137150466
11,38,0.608796296296,0.658307210031,0.706989247312,0.554089709763,0.654228855721,0.601719197708,372,379,210,169,109,263,0.62982689747
11,39,0.668380462725,0.665745856354,0.682414698163,0.651351351351,0.675324675325,0.658469945355,381,370,241,129,121,260,0.667110519308
11,40,0.62945368171,0.669696969697,0.708556149733,0.586206896552,0.666666666667,0.625176803395,374,377,221,156,109,265,0.647137150466
11,41,0.629186602871,0.672672672673,0.706989247312,0.591029023747,0.66582278481,0.629213483146,372,379,224,155,109,263,0.648468708389
11,42,0.650124069479,0.672413793103,0.696808510638,0.624,0.672657252888,0.647302904564,376,375,234,141,114,262,0.660452729694
11,43,0.604761904762,0.616314199396,0.666666666667,0.551351351351,0.634207240949,0.582025677603,381,370,204,166,127,254,0.609853528628
11,44,0.603773584906,0.645259938838,0.688172043011,0.55672823219,0.643216080402,0.597733711048,372,379,211,168,116,256,0.621837549933
11,45,0.617283950617,0.627167630058,0.65963060686,0.583333333333,0.637755102041,0.604456824513,379,372,217,155,129,250,0.621837549933
11,46,0.650259067358,0.641095890411,0.657068062827,0.634146341463,0.653645833333,0.637602179837,382,369,234,135,131,251,0.645805592543
11,47,0.625287356322,0.683544303797,0.731182795699,0.569920844327,0.674101610905,0.621582733813,372,379,216,163,100,272,0.649800266312
11,48,0.603773584906,0.645259938838,0.688172043011,0.55672823219,0.643216080402,0.597733711048,372,379,211,168,116,256,0.621837549933
11,49,0.629186602871,0.654654654655,0.695767195767,0.584450402145,0.660804020101,0.617563739377,378,373,218,155,115,263,0.640479360852
11,50,0.61975308642,0.64450867052,0.671122994652,0.59151193634,0.644415917843,0.616874135546,374,377,223,154,123,251,0.631158455393
11,51,0.638403990025,0.645714285714,0.673684210526,0.609164420485,0.65556978233,0.626907073509,380,371,226,145,124,256,0.641810918775
11,52,0.65671641791,0.659025787966,0.689295039164,0.625,0.672611464968,0.641562064156,383,368,230,138,119,264,0.657789613848
11,53,0.602941176471,0.644314868805,0.66847826087,0.577023498695,0.634020618557,0.608815426997,368,383,221,162,122,246,0.621837549933
11,54,0.675062972292,0.694915254237,0.712765957447,0.656,0.69340232859,0.674897119342,376,375,246,129,108,268,0.684420772304
11,55,0.575757575758,0.640138408304,0.718918918919,0.485564304462,0.639423076923,0.55223880597,370,381,185,196,104,266,0.600532623169
11,56,0.656097560976,0.680351906158,0.71164021164,0.621983914209,0.682741116751,0.649859943978,378,373,232,141,109,269,0.667110519308
11,57,0.64857881137,0.642857142857,0.658792650919,0.632432432432,0.653645833333,0.637602179837,381,370,234,136,130,251,0.645805592543
11,58,0.61975308642,0.635838150289,0.665782493369,0.588235294118,0.641943734015,0.611111111111,377,374,220,154,126,251,0.627163781625
11,59,0.60599078341,0.662460567823,0.710810810811,0.551181102362,0.654228855721,0.601719197708,370,381,210,171,107,263,0.62982689747
11,60,0.614250614251,0.656976744186,0.679347826087,0.590078328982,0.645161290323,0.621733149931,368,383,226,157,118,250,0.633821571238
11,61,0.605839416058,0.655882352941,0.680327868852,0.579220779221,0.640926640927,0.615172413793,366,385,223,162,117,249,0.628495339547
11,62,0.633165829146,0.657223796034,0.675603217158,0.613756613757,0.653696498054,0.634746922025,373,378,232,146,121,252,0.644474034621
11,63,0.637717121588,0.66091954023,0.685333333333,0.61170212766,0.660668380463,0.635359116022,375,376,230,146,118,257,0.648468708389
11,64,0.611374407583,0.623100303951,0.675392670157,0.555555555556,0.641791044776,0.587392550143,382,369,205,164,124,258,0.616511318242
11,65,0.592875318066,0.59217877095,0.614775725594,0.569892473118,0.603626943005,0.580821917808,379,372,212,160,146,233,0.592543275632
11,66,0.638349514563,0.657817109145,0.693931398417,0.599462365591,0.664981036662,0.627285513361,379,372,223,149,116,263,0.647137150466
11,67,0.640897755611,0.68,0.69647696477,0.623036649215,0.667532467532,0.650273224044,369,382,238,144,112,257,0.659121171771
11,68,0.65625,0.671641791045,0.712793733681,0.611413043478,0.683354192741,0.640113798009,383,368,225,143,110,273,0.663115845539
11,69,0.6325,0.652421652422,0.674666666667,0.609042553191,0.652903225806,0.629986244842,375,376,229,147,122,253,0.641810918775
11,70,0.65601965602,0.683139534884,0.710106382979,0.626666666667,0.681992337165,0.653685674548,376,375,235,140,109,267,0.66844207723
11,71,0.635265700483,0.640949554896,0.684895833333,0.588555858311,0.659147869674,0.613636363636,384,367,216,151,121,263,0.637816245007
11,72,0.641791044776,0.63323782235,0.668393782383,0.605479452055,0.654822335025,0.619047619048,386,365,221,144,128,258,0.637816245007
11,73,0.618721461187,0.670926517572,0.724598930481,0.557029177719,0.667487684729,0.608695652174,374,377,210,167,103,271,0.640479360852
11,74,0.577181208054,0.621710526316,0.691689008043,0.5,0.629268292683,0.554252199413,373,378,189,189,115,258,0.595206391478
11,75,0.633495145631,0.666666666667,0.697860962567,0.599469496021,0.664122137405,0.631284916201,374,377,226,151,113,261,0.648468708389
11,76,0.634920634921,0.646112600536,0.645161290323,0.635883905013,0.64,0.640957446809,372,379,241,138,132,240,0.640479360852
11,77,0.617715617716,0.639751552795,0.695538057743,0.556756756757,0.654320987654,0.595375722543,381,370,206,164,116,265,0.627163781625
11,78,0.62962962963,0.650289017341,0.678191489362,0.6,0.653008962868,0.624133148405,376,375,225,150,121,255,0.639147802929
11,79,0.623529411765,0.653374233129,0.701058201058,0.571045576408,0.6600249066,0.609442060086,378,373,213,160,113,265,0.636484687084
11,80,0.621749408983,0.67987804878,0.714673913043,0.582245430809,0.664981036662,0.627285513361,368,383,223,160,105,263,0.647137150466
11,81,0.653110047847,0.681681681682,0.720316622691,0.610215053763,0.685069008783,0.643971631206,379,372,227,145,106,273,0.665778961385
11,82,0.646464646465,0.670422535211,0.686327077748,0.62962962963,0.665799739922,0.649386084584,373,378,238,140,117,256,0.657789613848
11,83,0.661835748792,0.6646884273,0.708010335917,0.615384615385,0.684144818976,0.639087018545,387,364,224,140,113,274,0.663115845539
11,84,0.620608899297,0.638888888889,0.693717277487,0.560975609756,0.655129789864,0.597402597403,382,369,207,162,117,265,0.628495339547
11,85,0.634020618557,0.644628099174,0.656,0.622340425532,0.644823066841,0.633288227334,375,376,234,142,129,246,0.639147802929
11,86,0.614512471655,0.683870967742,0.734417344173,0.55497382199,0.669135802469,0.612716763006,369,382,212,170,98,271,0.643142476698
11,87,0.633333333333,0.667673716012,0.707446808511,0.589333333333,0.668341708543,0.626062322946,376,375,221,154,110,266,0.648468708389
11,88,0.622327790974,0.657575757576,0.698666666667,0.577127659574,0.658291457286,0.614730878187,375,376,217,159,113,262,0.637816245007
11,89,0.6275,0.641025641026,0.665782493369,0.601604278075,0.646074646075,0.620689655172,377,374,225,149,126,251,0.633821571238
11,90,0.642685851319,0.688622754491,0.720430107527,0.606860158311,0.679340937896,0.645161290323,372,379,230,149,104,268,0.663115845539
11,91,0.598130841121,0.628482972136,0.68085106383,0.541333333333,0.636815920398,0.581661891117,376,375,203,172,120,256,0.611185086551
11,92,0.624390243902,0.645161290323,0.679045092838,0.588235294118,0.650571791614,0.615384615385,377,374,220,154,121,256,0.633821571238
11,93,0.610978520286,0.647590361446,0.686327077748,0.568783068783,0.646464646465,0.605633802817,373,378,215,163,117,256,0.627163781625
11,94,0.626535626536,0.636627906977,0.671052631579,0.590296495957,0.648030495553,0.612587412587,380,371,219,152,125,255,0.631158455393
11,95,0.634961439589,0.638121546961,0.653439153439,0.619302949062,0.64406779661,0.628571428571,378,373,231,142,131,247,0.636484687084
11,96,0.632558139535,0.669781931464,0.719576719577,0.576407506702,0.673267326733,0.619596541787,378,373,215,158,106,272,0.648468708389
11,97,0.658476658477,0.665697674419,0.699738903394,0.622282608696,0.678481012658,0.643258426966,383,368,229,139,115,268,0.661784287617
11,98,0.63,0.641025641026,0.666666666667,0.603217158177,0.647814910026,0.621546961326,378,373,225,148,126,252,0.635153129161
11,99,0.581395348837,0.632398753894,0.679347826087,0.530026109661,0.62656641604,0.576704545455,368,383,203,180,118,250,0.603195739015
13,0,0.637055837563,0.655462184874,0.671122994652,0.620689655172,0.653645833333,0.637602179837,374,377,234,143,123,251,0.645805592543
13,1,0.621559633028,0.685714285714,0.732432432432,0.566929133858,0.672456575682,0.620689655172,370,381,216,165,99,271,0.648468708389
13,2,0.594036697248,0.634920634921,0.692513368984,0.53050397878,0.63950617284,0.578034682081,374,377,200,177,115,259,0.611185086551
13,3,0.64691943128,0.668693009119,0.714659685864,0.59620596206,0.679104477612,0.630372492837,382,369,220,149,109,273,0.656458055925
13,4,0.6592039801,0.687679083095,0.708556149733,0.636604774536,0.682989690722,0.661157024793,374,377,240,137,109,265,0.672436750999
13,5,0.629353233831,0.661891117479,0.681940700809,0.607894736842,0.654592496766,0.633744855967,371,380,231,149,118,253,0.644474034621
13,6,0.608108108108,0.664495114007,0.723860589812,0.539682539683,0.660954712362,0.595620437956,373,378,204,174,103,270,0.631158455393
13,7,0.635321100917,0.698412698413,0.744623655914,0.580474934037,0.685643564356,0.634005763689,372,379,220,159,95,277,0.661784287617
13,8,0.640776699029,0.666666666667,0.700265251989,0.604278074866,0.669201520913,0.633941093969,377,374,226,148,113,264,0.652463382157
13,9,0.625,0.644314868805,0.676392572944,0.590909090909,0.649681528662,0.616457461646,377,374,221,153,122,255,0.633821571238
13,10,0.649880095923,0.676646706587,0.715039577836,0.60752688172,0.680904522613,0.640226628895,379,372,226,146,108,271,0.661784287617
13,11,0.62380952381,0.658610271903,0.698666666667,0.579787234043,0.659119496855,0.616690240453,375,376,218,158,113,262,0.639147802929
13,12,0.636138613861,0.657060518732,0.683510638298,0.608,0.658974358974,0.631578947368,376,375,228,147,119,257,0.645805592543
13,13,0.607305936073,0.661341853035,0.715053763441,0.54617414248,0.656790123457,0.598265895954,372,379,207,172,106,266,0.62982689747
13,14,0.649253731343,0.661891117479,0.688654353562,0.620967741935,0.668373879641,0.640776699029,379,372,231,141,118,261,0.655126498003
13,15,0.611627906977,0.647975077882,0.699468085106,0.554666666667,0.652605459057,0.597701149425,376,375,208,167,113,263,0.627163781625
13,16,0.648293963255,0.637837837838,0.648293963255,0.637837837838,0.648293963255,0.637837837838,381,370,236,134,134,247,0.643142476698
13,17,0.63981042654,0.674772036474,0.716180371353,0.593582887701,0.675844806008,0.631578947368,377,374,222,152,107,270,0.655126498003
13,18,0.633165829146,0.662889518414,0.679245283019,0.615789473684,0.655396618986,0.638472032742,371,380,234,146,119,252,0.647137150466
13,19,0.61961722488,0.657657657658,0.69436997319,0.579365079365,0.654867256637,0.616033755274,373,378,219,159,114,259,0.636484687084
13,20,0.647668393782,0.657534246575,0.666666666667,0.63829787234,0.65703022339,0.647773279352,375,376,240,136,125,250,0.652463382157
13,21,0.588914549654,0.62893081761,0.683646112601,0.529100529101,0.632754342432,0.574712643678,373,378,200,178,118,255,0.60585885486
13,22,0.628504672897,0.66253869969,0.71164021164,0.573726541555,0.667493796526,0.614942528736,378,373,214,159,109,269,0.643142476698
13,23,0.617647058824,0.63556851312,0.668435013263,0.582887700535,0.642038216561,0.608089260809,377,374,218,156,125,252,0.625832223702
13,24,0.628440366972,0.666666666667,0.722955145119,0.564516129032,0.672392638037,0.61135371179,379,372,210,162,105,274,0.644474034621
13,25,0.65625,0.653950953678,0.664907651715,0.645161290323,0.660550458716,0.649526387009,379,372,240,132,127,252,0.655126498003
13,26,0.6,0.649546827795,0.684782608696,0.56135770235,0.639593908629,0.602240896359,368,383,215,168,116,252,0.621837549933
13,27,0.621686746988,0.651785714286,0.688,0.582446808511,0.653164556962,0.615168539326,375,376,219,157,117,258,0.635153129161
13,28,0.622276029056,0.659763313609,0.690860215054,0.588390501319,0.654777070064,0.622036262204,372,379,223,156,115,257,0.639147802929
13,29,0.616438356164,0.674121405751,0.725806451613,0.55672823219,0.666666666667,0.609826589595,372,379,211,168,102,270,0.640479360852
13,30,0.620224719101,0.66339869281,0.728232189974,0.545698924731,0.669902912621,0.598820058997,379,372,203,169,103,276,0.637816245007
13,31,0.628235294118,0.650306748466,0.700787401575,0.572972972973,0.66253101737,0.609195402299,381,370,212,158,114,267,0.637816245007
13,32,0.646778042959,0.656626506024,0.703896103896,0.595628415301,0.674129353234,0.624641833811,385,366,218,148,114,271,0.651131824234
13,33,0.627078384798,0.648484848485,0.694736842105,0.576819407008,0.659176029963,0.610556348074,380,371,214,157,116,264,0.636484687084
13,34,0.617021276596,0.655487804878,0.697860962567,0.570291777188,0.65495608532,0.609929078014,374,377,215,162,113,261,0.633821571238
13,35,0.639902676399,0.655882352941,0.692105263158,0.601078167116,0.664981036662,0.627285513361,380,371,223,148,117,263,0.647137150466
13,36,0.609480812641,0.668831168831,0.725806451613,0.543535620053,0.662576687117,0.599708879185,372,379,206,173,102,270,0.633821571238
13,37,0.669926650367,0.690058479532,0.721052631579,0.636118598383,0.694550063371,0.661991584853,380,371,236,135,106,274,0.679094540613
13,38,0.616161616162,0.650704225352,0.663043478261,0.603133159269,0.638743455497,0.626016260163,368,383,231,152,124,244,0.632490013316
13,39,0.641723356009,0.677419354839,0.738903394256,0.570652173913,0.686893203883,0.619469026549,383,368,210,158,100,283,0.656458055925
13,40,0.6675,0.666666666667,0.6953125,0.637602179837,0.68112244898,0.651810584958,384,367,234,133,117,267,0.667110519308
13,41,0.625866050808,0.698113207547,0.738419618529,0.578125,0.6775,0.632478632479,367,384,222,162,96,271,0.656458055925
13,42,0.653658536585,0.677419354839,0.708994708995,0.619302949062,0.680203045685,0.647058823529,378,373,231,142,110,268,0.664447403462
13,43,0.625603864734,0.658753709199,0.692513368984,0.588859416446,0.657360406091,0.621848739496,374,377,222,155,115,259,0.640479360852
13,44,0.615201900238,0.657575757576,0.69623655914,0.572559366755,0.653215636822,0.612129760226,372,379,217,162,113,259,0.633821571238
13,45,0.622009569378,0.678678678679,0.708446866485,0.588541666667,0.662420382166,0.63040446304,367,384,226,158,107,260,0.647137150466
13,46,0.625615763547,0.652173913043,0.679144385027,0.596816976127,0.651282051282,0.623268698061,374,377,225,152,120,254,0.637816245007
13,47,0.626829268293,0.66568914956,0.692722371968,0.597368421053,0.658130601793,0.629680998613,371,380,227,153,114,257,0.644474034621
13,48,0.631067961165,0.6401179941,0.680628272251,0.588075880759,0.654911838791,0.612994350282,382,369,217,152,122,260,0.635153129161
13,49,0.625,0.671641791045,0.702702702703,0.590551181102,0.661577608142,0.628491620112,370,381,225,156,110,260,0.645805592543
13,50,0.643734643735,0.668604651163,0.696808510638,0.613333333333,0.669220945083,0.639777468707,376,375,230,145,114,262,0.655126498003
13,51,0.640826873385,0.64010989011,0.654353562005,0.626344086022,0.647519582245,0.633152173913,379,372,233,139,131,248,0.640479360852
13,52,0.642857142857,0.675362318841,0.699731903485,0.616402116402,0.670089858793,0.644536652835,373,378,233,145,112,261,0.657789613848
13,53,0.604910714286,0.673267326733,0.732432432432,0.535433070866,0.662591687042,0.59649122807,370,381,204,177,99,271,0.632490013316
13,54,0.606818181818,0.633440514469,0.700787401575,0.532432432432,0.650426309379,0.578560939794,381,370,197,173,114,267,0.617842876165
13,55,0.630952380952,0.655589123867,0.699208443272,0.583333333333,0.663329161452,0.617354196302,379,372,217,155,114,265,0.641810918775
13,56,0.660146699267,0.669590643275,0.704960835509,0.622282608696,0.681818181818,0.645070422535,383,368,229,139,113,270,0.664447403462
13,57,0.592677345538,0.633757961783,0.692513368984,0.527851458886,0.638717632552,0.575976845152,374,377,199,178,115,259,0.609853528628
13,58,0.592592592593,0.626959247649,0.682666666667,0.531914893617,0.634448574969,0.575539568345,375,376,200,176,119,256,0.607190412783
13,59,0.582969432314,0.651877133106,0.723577235772,0.5,0.645707376058,0.565925925926,369,382,191,191,102,267,0.609853528628
13,60,0.653562653563,0.651162790698,0.689119170984,0.613698630137,0.670870113493,0.631875881523,386,365,224,141,120,266,0.652463382157
13,61,0.592841163311,0.667763157895,0.724043715847,0.527272727273,0.651906519065,0.589259796807,366,385,203,182,101,265,0.623169107856
13,62,0.608988764045,0.686274509804,0.738419618529,0.546875,0.667487684729,0.608695652174,367,384,210,174,96,271,0.640479360852
13,63,0.604651162791,0.688473520249,0.722222222222,0.565217391304,0.658227848101,0.620786516854,360,391,221,170,100,260,0.640479360852
13,64,0.63567839196,0.665722379603,0.681940700809,0.618421052632,0.65799739922,0.641200545703,371,380,235,145,118,253,0.649800266312
13,65,0.630434782609,0.673590504451,0.703504043127,0.597368421053,0.664968152866,0.633193863319,371,380,227,153,110,261,0.649800266312
13,66,0.619047619048,0.628398791541,0.678851174935,0.565217391304,0.647571606476,0.595135908441,383,368,208,160,123,260,0.623169107856
13,67,0.624390243902,0.642228739003,0.677248677249,0.587131367292,0.649746192893,0.613445378151,378,373,219,154,122,256,0.632490013316
13,68,0.616407982262,0.683333333333,0.745308310992,0.542328042328,0.674757281553,0.604719764012,373,378,205,173,95,278,0.643142476698
13,69,0.62443438914,0.663430420712,0.726315789474,0.5525606469,0.671532846715,0.602941176471,380,371,205,166,104,276,0.640479360852
13,70,0.616279069767,0.657320872274,0.706666666667,0.561170212766,0.658385093168,0.605451936872,375,376,211,165,110,265,0.633821571238
13,71,0.61,0.62962962963,0.652406417112,0.586206896552,0.630490956072,0.607142857143,374,377,221,156,130,244,0.619174434088
13,72,0.647783251232,0.669565217391,0.697612732095,0.617647058824,0.671775223499,0.642559109875,377,374,231,143,114,263,0.657789613848
13,73,0.616306954436,0.673652694611,0.70218579235,0.584415584416,0.656449553001,0.625869262865,366,385,225,160,109,257,0.641810918775
13,74,0.619815668203,0.681388012618,0.727027027027,0.566929133858,0.669154228856,0.618911174785,370,381,216,165,101,269,0.645805592543
13,75,0.618181818182,0.659163987138,0.719576719577,0.549597855228,0.665036674817,0.599415204678,378,373,205,168,106,272,0.635153129161
13,76,0.609302325581,0.657320872274,0.704301075269,0.55672823219,0.653366583541,0.602857142857,372,379,211,168,110,262,0.62982689747
13,77,0.635491606715,0.649700598802,0.693717277487,0.588075880759,0.663329161452,0.617354196302,382,369,217,152,117,265,0.641810918775
13,78,0.598152424942,0.657232704403,0.703804347826,0.545691906005,0.646691635456,0.596291012839,368,383,209,174,109,259,0.623169107856
13,79,0.621827411168,0.616246498599,0.641361256545,0.59620596206,0.631443298969,0.606060606061,382,369,220,149,137,245,0.619174434088
13,80,0.616071428571,0.663366336634,0.730158730159,0.538873994638,0.668280871671,0.594674556213,378,373,201,172,102,276,0.635153129161
13,81,0.652709359606,0.649275362319,0.686528497409,0.613698630137,0.669191919192,0.630985915493,386,365,224,141,121,265,0.651131824234
13,82,0.636579572447,0.660606060606,0.705263157895,0.587601078167,0.669163545568,0.621968616262,380,371,218,153,112,268,0.647137150466
13,83,0.671794871795,0.689750692521,0.700534759358,0.660477453581,0.685863874346,0.674796747967,374,377,249,128,112,262,0.680426098535
13,84,0.634382566586,0.647928994083,0.687664041995,0.591891891892,0.659949622166,0.618644067797,381,370,219,151,119,262,0.640479360852
13,85,0.626865671642,0.647564469914,0.672,0.601063829787,0.648648648649,0.623448275862,375,376,226,150,123,252,0.636484687084
13,86,0.641148325359,0.690690690691,0.722371967655,0.605263157895,0.679340937896,0.645161290323,371,380,230,150,103,268,0.663115845539
13,87,0.61985472155,0.647928994083,0.682666666667,0.582446808511,0.649746192893,0.613445378151,375,376,219,157,119,256,0.632490013316
13,88,0.667475728155,0.684365781711,0.719895287958,0.628726287263,0.692695214106,0.655367231638,382,369,232,137,107,275,0.675099866844
13,89,0.646153846154,0.648199445983,0.664907651715,0.629032258065,0.655396618986,0.638472032742,379,372,234,138,127,252,0.647137150466
13,90,0.605140186916,0.659442724458,0.70189701897,0.557591623037,0.649937264743,0.604255319149,369,382,213,169,110,259,0.628495339547
13,91,0.683804627249,0.696132596685,0.707446808511,0.672,0.695424836601,0.683853459973,376,375,252,123,110,266,0.689747003995
13,92,0.641646489104,0.677514792899,0.708556149733,0.607427055703,0.673443456163,0.640559440559,374,377,229,148,109,265,0.657789613848
13,93,0.632754342432,0.637931034483,0.669291338583,0.6,0.650510204082,0.618384401114,381,370,222,148,126,255,0.635153129161
13,94,0.626903553299,0.635854341737,0.655172413793,0.606951871658,0.640726329442,0.621067031464,377,374,227,147,130,247,0.631158455393
13,95,0.623222748815,0.656534954407,0.699468085106,0.576,0.659147869674,0.613636363636,376,375,216,159,113,263,0.637816245007
13,96,0.651105651106,0.68023255814,0.706666666667,0.622340425532,0.677749360614,0.65,375,376,234,142,110,265,0.664447403462
13,97,0.597315436242,0.677631578947,0.731506849315,0.533678756477,0.65763546798,0.597101449275,365,386,206,180,98,267,0.62982689747
13,98,0.634615384615,0.674626865672,0.707774798928,0.597883597884,0.669201520913,0.633941093969,373,378,226,152,109,264,0.652463382157
13,99,0.605700712589,0.645454545455,0.685483870968,0.562005277045,0.643127364439,0.600846262341,372,379,213,166,117,255,0.623169107856
15,0,0.63309352518,0.673652694611,0.707774798928,0.595238095238,0.66835443038,0.63202247191,373,378,225,153,109,264,0.651131824234
15,1,0.622596153846,0.65671641791,0.692513368984,0.583554376658,0.655696202532,0.61797752809,374,377,220,157,115,259,0.637816245007
15,2,0.605568445476,0.640625,0.69414893617,0.546666666667,0.646840148699,0.589928057554,376,375,205,170,115,261,0.620505992011
15,3,0.637254901961,0.66472303207,0.693333333333,0.606382978723,0.66411238825,0.63421418637,375,376,228,148,115,260,0.649800266312
15,4,0.628498727735,0.648044692737,0.662198391421,0.613756613757,0.644908616188,0.630434782609,373,378,232,146,126,247,0.637816245007
15,5,0.634844868735,0.659638554217,0.701846965699,0.588709677419,0.666666666667,0.622159090909,379,372,219,153,113,266,0.645805592543
15,6,0.62676056338,0.643076923077,0.697127937337,0.567934782609,0.660074165637,0.603174603175,383,368,209,159,116,267,0.633821571238
15,7,0.635933806147,0.685975609756,0.72311827957,0.593667546174,0.676729559748,0.636492220651,372,379,225,154,103,269,0.657789613848
15,8,0.642201834862,0.692063492063,0.742705570292,0.582887700535,0.688806888069,0.632801161103,377,374,218,156,97,280,0.663115845539
15,9,0.625592417062,0.653495440729,0.698412698413,0.576407506702,0.66,0.612535612536,378,373,215,158,114,264,0.637816245007
15,10,0.636363636364,0.672672672673,0.709333333333,0.595744680851,0.670870113493,0.631875881523,375,376,224,152,109,266,0.652463382157
15,11,0.630841121495,0.671826625387,0.718085106383,0.578666666667,0.671641791045,0.621776504298,376,375,217,158,106,270,0.648468708389
15,12,0.612009237875,0.676100628931,0.720108695652,0.56135770235,0.661672908864,0.613409415121,368,383,215,168,103,265,0.639147802929
15,13,0.659523809524,0.691842900302,0.730870712401,0.615591397849,0.693366708385,0.651493598862,379,372,229,143,102,277,0.673768308921
15,14,0.632352941176,0.67638483965,0.69918699187,0.607329842932,0.664092664093,0.64,369,382,232,150,111,258,0.652463382157
15,15,0.652392947103,0.675141242938,0.692513368984,0.633952254642,0.671854734112,0.65389876881,374,377,239,138,115,259,0.663115845539
15,16,0.666666666667,0.659340659341,0.675392670157,0.650406504065,0.67100130039,0.654843110505,382,369,240,129,124,258,0.663115845539
15,17,0.603325415677,0.624242424242,0.671957671958,0.552278820375,0.635794743429,0.586059743954,378,373,206,167,124,254,0.612516644474
15,18,0.634803921569,0.667638483965,0.69436997319,0.60582010582,0.663252240717,0.635228848821,373,378,229,149,114,259,0.649800266312
15,19,0.632318501171,0.688271604938,0.727762803235,0.586842105263,0.676691729323,0.633522727273,371,380,223,157,101,270,0.656458055925
15,20,0.61625282167,0.672077922078,0.729946524064,0.549071618037,0.668298653611,0.604379562044,374,377,207,170,101,273,0.639147802929
15,21,0.61716937355,0.6875,0.726775956284,0.571428571429,0.667503136763,0.624113475177,366,385,220,165,100,266,0.647137150466
15,22,0.62829736211,0.661676646707,0.698666666667,0.587765957447,0.661616161616,0.622535211268,375,376,221,155,113,262,0.643142476698
15,23,0.635265700483,0.646884272997,0.688481675393,0.590785907859,0.660804020101,0.617563739377,382,369,218,151,119,263,0.640479360852
15,24,0.664921465969,0.663956639566,0.671957671958,0.656836461126,0.668421052632,0.660377358491,378,373,245,128,124,254,0.664447403462
15,25,0.655860349127,0.68,0.701333333333,0.632978723404,0.677835051546,0.65564738292,375,376,238,138,112,263,0.667110519308
15,26,0.624423963134,0.675078864353,0.724598930481,0.567639257294,0.670792079208,0.616714697406,374,377,214,163,103,271,0.645805592543
15,27,0.619952494062,0.630303030303,0.681462140992,0.565217391304,0.649253731343,0.595988538682,383,368,208,160,122,261,0.624500665779
15,28,0.632941176471,0.674846625767,0.717333333333,0.585106382979,0.6725,0.626780626781,375,376,220,156,106,269,0.651131824234
15,29,0.629268292683,0.627565982405,0.67012987013,0.584699453552,0.649056603774,0.605374823197,385,366,214,152,127,258,0.628495339547
15,30,0.610978520286,0.650602409639,0.688172043011,0.569920844327,0.647281921618,0.607594936709,372,379,216,163,116,256,0.628495339547
15,31,0.601990049751,0.63323782235,0.654054054054,0.580052493438,0.626943005181,0.605479452055,370,381,221,160,128,242,0.616511318242
15,32,0.628504672897,0.650154798762,0.704188481675,0.569105691057,0.664197530864,0.606936416185,382,369,210,159,113,269,0.637816245007
15,33,0.640522875817,0.695205479452,0.767624020888,0.551630434783,0.698337292162,0.615151515152,383,368,203,165,89,294,0.661784287617
15,34,0.607655502392,0.675675675676,0.701657458564,0.578406169666,0.651282051282,0.623268698061,362,389,225,164,108,254,0.637816245007
15,35,0.664974619289,0.672268907563,0.691292875989,0.645161290323,0.67787839586,0.658436213992,379,372,240,132,117,262,0.66844207723
15,36,0.605200945626,0.646341463415,0.688172043011,0.559366754617,0.644025157233,0.599717114569,372,379,212,167,116,256,0.623169107856
15,37,0.641089108911,0.657060518732,0.685185185185,0.611260053619,0.662404092072,0.633333333333,378,373,228,145,119,259,0.648468708389
15,38,0.63768115942,0.673590504451,0.705882352941,0.602122015915,0.670050761421,0.635854341737,374,377,227,150,110,264,0.65379494008
15,39,0.611764705882,0.644171779141,0.691489361702,0.56,0.649188514357,0.599144079886,376,375,210,165,116,260,0.625832223702
15,40,0.629107981221,0.661538461538,0.708994708995,0.576407506702,0.666666666667,0.616045845272,378,373,215,158,110,268,0.643142476698
15,41,0.61716937355,0.665625,0.713136729223,0.563492063492,0.661691542289,0.610315186246,373,378,213,165,107,266,0.637816245007
15,42,0.63523573201,0.666666666667,0.688172043011,0.612137203166,0.66064516129,0.638239339752,372,379,232,147,116,256,0.649800266312
15,43,0.643410852713,0.648351648352,0.660477453581,0.631016042781,0.651832460733,0.639566395664,377,374,236,138,128,249,0.645805592543
15,44,0.635933806147,0.667682926829,0.71164021164,0.587131367292,0.671660424469,0.62482168331,378,373,219,154,109,269,0.649800266312
15,45,0.669902912621,0.669616519174,0.711340206186,0.625344352617,0.69,0.646723646724,388,363,227,136,112,276,0.669773635153
15,46,0.638820638821,0.627906976744,0.670103092784,0.595041322314,0.654088050314,0.611032531825,388,363,216,147,128,260,0.633821571238
15,47,0.665024630542,0.704347826087,0.725806451613,0.641160949868,0.694087403599,0.671270718232,372,379,243,136,102,270,0.683089214381
15,48,0.639618138425,0.680722891566,0.716577540107,0.599469496021,0.675914249685,0.637517630465,374,377,226,151,106,268,0.657789613848
15,49,0.626506024096,0.651785714286,0.689655172414,0.585561497326,0.656565656566,0.616901408451,377,374,219,155,117,260,0.637816245007
15,50,0.640845070423,0.673846153846,0.720316622691,0.588709677419,0.678260869565,0.628407460545,379,372,219,153,106,273,0.655126498003
15,51,0.610619469027,0.685618729097,0.745945945946,0.538057742782,0.671532846715,0.602941176471,370,381,205,176,94,276,0.640479360852
15,52,0.639344262295,0.697530864198,0.735849056604,0.594736842105,0.684210526316,0.642045454545,371,380,226,154,98,273,0.664447403462
15,53,0.642335766423,0.658823529412,0.694736842105,0.603773584906,0.667509481669,0.630098452883,380,371,224,147,116,264,0.649800266312
15,54,0.630541871921,0.663768115942,0.688172043011,0.604221635884,0.658097686375,0.632596685083,372,379,229,150,116,256,0.645805592543
15,55,0.622317596567,0.708771929825,0.777479892761,0.534391534392,0.691299165673,0.609351432881,373,378,202,176,83,290,0.655126498003
15,56,0.632318501171,0.675925925926,0.72,0.582446808511,0.673316708229,0.625714285714,375,376,219,157,105,270,0.651131824234
15,57,0.632420091324,0.686900958466,0.738666666667,0.571808510638,0.681426814268,0.624092888244,375,376,215,161,98,277,0.655126498003
15,58,0.647482014388,0.685628742515,0.72,0.609042553191,0.681818181818,0.645070422535,375,376,229,147,105,270,0.664447403462
15,59,0.660804020101,0.688385269122,0.70509383378,0.642857142857,0.682230869001,0.664842681259,373,378,243,135,110,263,0.673768308921
15,60,0.638461538462,0.662049861496,0.67115902965,0.628947368421,0.654402102497,0.645074224022,371,380,239,141,122,249,0.649800266312
15,61,0.654228855721,0.670487106017,0.695767195767,0.627345844504,0.674358974359,0.648199445983,378,373,234,139,115,263,0.661784287617
15,62,0.599557522124,0.672240802676,0.734417344173,0.526178010471,0.660170523752,0.590308370044,369,382,201,181,98,271,0.628495339547
15,63,0.622871046229,0.635294117647,0.673684210526,0.582210242588,0.647281921618,0.607594936709,380,371,216,155,124,256,0.628495339547
15,64,0.639150943396,0.678899082569,0.720744680851,0.592,0.6775,0.632478632479,376,375,222,153,105,271,0.656458055925
15,65,0.65617433414,0.659763313609,0.70207253886,0.61095890411,0.678347934919,0.634423897582,386,365,223,142,115,271,0.657789613848
15,66,0.647201946472,0.676470588235,0.707446808511,0.613333333333,0.675984752224,0.643356643357,376,375,230,145,110,266,0.660452729694
15,67,0.678100263852,0.658602150538,0.669270833333,0.66757493188,0.673656618611,0.663058186739,384,367,245,122,127,257,0.66844207723
15,68,0.605700712589,0.633333333333,0.678191489362,0.557333333333,0.639899623588,0.592907801418,376,375,209,166,121,255,0.617842876165
15,69,0.62962962963,0.677115987461,0.725333333333,0.574468085106,0.674101610905,0.621582733813,375,376,216,160,103,272,0.649800266312
15,70,0.646634615385,0.698507462687,0.727027027027,0.614173228346,0.684478371501,0.653631284916,370,381,234,147,101,269,0.669773635153
15,71,0.654501216545,0.664705882353,0.702349869452,0.614130434783,0.67758186398,0.638418079096,383,368,226,142,114,269,0.659121171771
15,72,0.630272952854,0.658045977011,0.680965147453,0.60582010582,0.654639175258,0.63085399449,373,378,229,149,119,254,0.643142476698
15,73,0.62100456621,0.67731629393,0.729222520107,0.560846560847,0.670776818742,0.613603473227,373,378,212,166,101,272,0.644474034621
15,74,0.608108108108,0.664495114007,0.723860589812,0.539682539683,0.660954712362,0.595620437956,373,378,204,174,103,270,0.631158455393
15,75,0.660804020101,0.671388101983,0.693931398417,0.637096774194,0.676962676963,0.653793103448,379,372,237,135,116,263,0.665778961385
15,76,0.625,0.6472303207,0.678191489362,0.592,0.650510204082,0.618384401114,376,375,222,153,121,255,0.635153129161
15,77,0.633004926108,0.663768115942,0.689008042895,0.60582010582,0.659820282413,0.63347164592,373,378,229,149,116,257,0.647137150466
15,78,0.63981042654,0.671732522796,0.714285714286,0.592493297587,0.675,0.62962962963,378,373,221,152,108,270,0.65379494008
15,79,0.631067961165,0.669616519174,0.698924731183,0.598944591029,0.663265306122,0.632311977716,372,379,227,152,112,260,0.648468708389
15,80,0.572984749455,0.643835616438,0.716621253406,0.489583333333,0.636803874092,0.556213017751,367,384,188,196,104,263,0.600532623169
15,81,0.649122807018,0.664772727273,0.68700265252,0.625668449198,0.667525773196,0.644628099174,377,374,234,140,118,259,0.656458055925
15,82,0.629107981221,0.658461538462,0.707124010554,0.575268817204,0.665838509317,0.61406025825,379,372,214,158,111,268,0.641810918775
15,83,0.639150943396,0.672782874618,0.716931216931,0.58981233244,0.675810473815,0.628571428571,378,373,220,153,107,271,0.65379494008
15,84,0.651851851852,0.684971098266,0.707774798928,0.626984126984,0.678663239075,0.654696132597,373,378,237,141,109,264,0.667110519308
15,85,0.62380952381,0.655589123867,0.696808510638,0.578666666667,0.658291457286,0.614730878187,376,375,217,158,114,262,0.637816245007
15,86,0.602197802198,0.662162162162,0.732620320856,0.519893899204,0.661037394451,0.582466567608,374,377,196,181,100,274,0.625832223702
15,87,0.654846335697,0.704268292683,0.74064171123,0.612732095491,0.695106649937,0.655319148936,374,377,231,146,97,277,0.676431424767
15,88,0.643203883495,0.672566371681,0.704787234043,0.608,0.672588832487,0.638655462185,376,375,228,147,111,265,0.656458055925
15,89,0.62315270936,0.655072463768,0.680107526882,0.596306068602,0.650385604113,0.624309392265,372,379,226,153,119,253,0.637816245007
15,90,0.663291139241,0.685393258427,0.700534759358,0.647214854111,0.681404421326,0.665757162347,374,377,244,133,112,262,0.673768308921
15,91,0.643373493976,0.678571428571,0.712,0.606382978723,0.675949367089,0.640449438202,375,376,228,148,108,267,0.659121171771
15,92,0.635,0.666666666667,0.684636118598,0.615789473684,0.658884565499,0.640218878249,371,380,234,146,117,254,0.649800266312
15,93,0.644607843137,0.67055393586,0.699468085106,0.613333333333,0.670918367347,0.640668523677,376,375,230,145,113,263,0.656458055925
15,94,0.633251833741,0.631578947368,0.672727272727,0.590163934426,0.652392947103,0.610169491525,385,366,216,150,126,259,0.632490013316
15,95,0.618226600985,0.652173913043,0.676549865229,0.592105263158,0.646074646075,0.620689655172,371,380,225,155,120,251,0.633821571238
15,96,0.638190954774,0.662889518414,0.680965147453,0.619047619048,0.658884565499,0.640218878249,373,378,234,144,119,254,0.649800266312
15,97,0.633333333333,0.664652567976,0.705570291777,0.588235294118,0.667503136763,0.624113475177,377,374,220,154,111,266,0.647137150466
15,98,0.61978021978,0.679054054054,0.74801061008,0.53743315508,0.677884615385,0.6,377,374,201,173,95,282,0.643142476698
15,99,0.640287769784,0.703592814371,0.729508196721,0.61038961039,0.681992337165,0.653685674548,366,385,235,150,99,267,0.66844207723
17,0,0.646464646465,0.67323943662,0.688172043011,0.630606860158,0.666666666667,0.651226158038,372,379,239,140,116,256,0.659121171771
17,1,0.641509433962,0.666666666667,0.713910761155,0.589189189189,0.675776397516,0.625538020086,381,370,218,152,109,272,0.652463382157
17,2,0.620608899297,0.666666666667,0.710455764075,0.571428571429,0.6625,0.615384615385,373,378,216,162,108,265,0.640479360852
17,3,0.651960784314,0.655976676385,0.692708333333,0.613079019074,0.671717171717,0.633802816901,384,367,225,142,118,266,0.65379494008
17,4,0.616091954023,0.683544303797,0.728260869565,0.563968668407,0.667496886675,0.618025751073,368,383,216,167,100,268,0.644474034621
17,5,0.595294117647,0.644171779141,0.685636856369,0.549738219895,0.637279596977,0.593220338983,369,382,210,172,116,253,0.616511318242
17,6,0.627962085308,0.674772036474,0.712365591398,0.585751978892,0.667506297229,0.627118644068,372,379,222,157,107,265,0.648468708389
17,7,0.593548387097,0.664335664336,0.741935483871,0.501319261214,0.659498207885,0.571428571429,372,379,190,189,96,276,0.620505992011
17,8,0.652709359606,0.675362318841,0.702917771883,0.622994652406,0.676883780332,0.648122392211,377,374,233,141,112,265,0.663115845539
17,9,0.613138686131,0.655882352941,0.682926829268,0.583769633508,0.646153846154,0.617728531856,369,382,223,159,117,252,0.632490013316
17,10,0.618705035971,0.667664670659,0.69918699187,0.583769633508,0.656488549618,0.622905027933,369,382,223,159,111,258,0.640479360852
17,11,0.645011600928,0.69375,0.739361702128,0.592,0.68897149938,0.638848920863,376,375,222,153,98,278,0.665778961385
17,12,0.620309050773,0.687919463087,0.751336898396,0.543766578249,0.679564691657,0.607407407407,374,377,205,172,93,281,0.647137150466
17,13,0.636363636364,0.690690690691,0.720867208672,0.602094240838,0.675984752224,0.643356643357,369,382,230,152,103,266,0.660452729694
17,14,0.650366748166,0.687134502924,0.713136729223,0.621693121693,0.680306905371,0.652777777778,373,378,235,143,107,266,0.667110519308
17,15,0.655256723716,0.681286549708,0.710875331565,0.622994652406,0.681933842239,0.650837988827,377,374,233,141,109,268,0.667110519308
17,16,0.622119815668,0.656151419558,0.712401055409,0.559139784946,0.664206642066,0.603773584906,379,372,208,164,109,270,0.636484687084
17,17,0.636144578313,0.666666666667,0.702127659574,0.597333333333,0.667509481669,0.630098452883,376,375,224,151,112,264,0.649800266312
17,18,0.636815920398,0.661891117479,0.68449197861,0.612732095491,0.659793814433,0.636363636364,374,377,231,146,118,256,0.648468708389
17,19,0.628504672897,0.681114551084,0.72311827957,0.580474934037,0.6725,0.626780626781,372,379,220,159,103,269,0.651131824234
17,20,0.665012406948,0.698275862069,0.718498659517,0.642857142857,0.690721649485,0.669421487603,373,378,243,135,105,268,0.680426098535
17,21,0.640963855422,0.696428571429,0.722826086957,0.610966057441,0.679438058748,0.65090403338,368,383,234,149,102,266,0.665778961385
17,22,0.608391608392,0.642857142857,0.69414893617,0.552,0.648447204969,0.593974175036,376,375,207,168,115,261,0.623169107856
17,23,0.60788863109,0.634375,0.691292875989,0.545698924731,0.646913580247,0.586705202312,379,372,203,169,117,262,0.619174434088
17,24,0.624161073826,0.6875,0.745989304813,0.554376657825,0.679658952497,0.613803230543,374,377,209,168,95,279,0.649800266312
17,25,0.674698795181,0.705357142857,0.738786279683,0.637096774194,0.705289672544,0.669491525424,379,372,237,135,99,280,0.688415446072
17,26,0.629107981221,0.64,0.696103896104,0.568306010929,0.660912453761,0.602026049204,385,366,208,158,117,268,0.633821571238
17,27,0.635933806147,0.655487804878,0.704188481675,0.582655826558,0.668322981366,0.616929698709,382,369,215,154,113,269,0.644474034621
17,28,0.645631067961,0.666666666667,0.701846965699,0.60752688172,0.672566371681,0.635724331927,379,372,226,146,113,266,0.655126498003
17,29,0.661538461538,0.653739612188,0.67362924282,0.641304347826,0.667529107374,0.647462277092,383,368,236,132,125,258,0.657789613848
17,30,0.625282167043,0.672077922078,0.732804232804,0.554959785523,0.674786845311,0.607929515419,378,373,207,166,101,277,0.644474034621
17,31,0.625287356322,0.670886075949,0.723404255319,0.565333333333,0.670776818742,0.613603473227,376,375,212,163,104,272,0.644474034621
17,32,0.663529411765,0.684049079755,0.732467532468,0.609289617486,0.696296296296,0.64450867052,385,366,223,143,103,282,0.672436750999
17,33,0.621686746988,0.666666666667,0.697297297297,0.587926509186,0.657324840764,0.624825662483,370,381,224,157,112,258,0.641810918775
17,34,0.644278606965,0.659025787966,0.685185185185,0.616621983914,0.664102564103,0.637119113573,378,373,230,143,119,259,0.651131824234
17,35,0.615560640732,0.665605095541,0.719251336898,0.554376657825,0.663378545006,0.60492040521,374,377,209,168,105,269,0.636484687084
17,36,0.665071770335,0.66966966967,0.716494845361,0.614325068871,0.68982630273,0.640804597701,388,363,223,140,110,278,0.667110519308
17,37,0.616279069767,0.679127725857,0.720108695652,0.569190600522,0.664160401003,0.619318181818,368,383,218,165,103,265,0.643142476698
17,38,0.626728110599,0.687697160883,0.733153638814,0.573684210526,0.675776397516,0.625538020086,371,380,218,162,99,272,0.652463382157
17,39,0.632286995516,0.67868852459,0.742105263158,0.55795148248,0.682808716707,0.612426035503,380,371,207,164,98,282,0.651131824234
17,40,0.626168224299,0.653250773994,0.705263157895,0.568733153639,0.663366336634,0.608069164265,380,371,211,160,112,268,0.637816245007
17,41,0.646616541353,0.65625,0.68073878628,0.620967741935,0.66323907455,0.638121546961,379,372,231,141,121,258,0.651131824234
17,42,0.624708624709,0.667701863354,0.714666666667,0.571808510638,0.666666666667,0.616045845272,375,376,215,161,107,268,0.643142476698
17,43,0.625850340136,0.693548387097,0.743935309973,0.565789473684,0.679802955665,0.623188405797,371,380,215,165,95,276,0.65379494008
17,44,0.625882352941,0.699386503067,0.730769230769,0.589147286822,0.674271229404,0.639551192146,364,387,228,159,98,266,0.657789613848
17,45,0.649164677804,0.707831325301,0.737127371274,0.615183246073,0.690355329949,0.658263305322,369,382,235,147,97,272,0.675099866844
17,46,0.618025751073,0.680701754386,0.759894459103,0.521505376344,0.681656804734,0.590563165906,379,372,194,178,91,288,0.641810918775
17,47,0.615384615385,0.645962732919,0.698412698413,0.55764075067,0.654275092937,0.598561151079,378,373,208,165,114,264,0.628495339547
17,48,0.636585365854,0.653958944282,0.688654353562,0.599462365591,0.661596958175,0.625525946704,379,372,223,149,118,261,0.644474034621
17,49,0.621315192744,0.690322580645,0.740540540541,0.561679790026,0.675709001233,0.619392185239,370,381,214,167,96,274,0.649800266312
17,50,0.63679245283,0.672782874618,0.716180371353,0.588235294118,0.674157303371,0.627674750357,377,374,220,154,107,270,0.652463382157
17,51,0.653944020356,0.678770949721,0.690860215054,0.641160949868,0.671895424837,0.659430122117,372,379,243,136,115,257,0.665778961385
17,52,0.648648648649,0.65988372093,0.692913385827,0.613513513514,0.670050761421,0.635854341737,381,370,227,143,117,264,0.65379494008
17,53,0.641646489104,0.686390532544,0.714285714286,0.610526315789,0.676020408163,0.646239554318,371,380,232,148,106,265,0.661784287617
17,54,0.662621359223,0.690265486726,0.722222222222,0.627345844504,0.691139240506,0.657303370787,378,373,234,139,105,273,0.675099866844
17,55,0.638190954774,0.662889518414,0.680965147453,0.619047619048,0.658884565499,0.640218878249,373,378,234,144,119,254,0.649800266312
17,56,0.628078817734,0.660869565217,0.685483870968,0.601583113456,0.655526992288,0.629834254144,372,379,228,151,117,255,0.643142476698
17,57,0.601321585903,0.686868686869,0.745901639344,0.52987012987,0.665853658537,0.598240469208,366,385,204,181,93,273,0.635153129161
17,58,0.61320754717,0.651376146789,0.695187165775,0.564986737401,0.651629072682,0.605113636364,374,377,213,164,114,260,0.62982689747
17,59,0.6038647343,0.635014836795,0.670241286863,0.566137566138,0.635324015248,0.598601398601,373,378,214,164,123,250,0.617842876165
17,60,0.626506024096,0.660714285714,0.695187165775,0.588859416446,0.659062103929,0.622720897616,374,377,222,155,114,260,0.641810918775
17,61,0.63950617284,0.64161849711,0.676240208877,0.603260869565,0.657360406091,0.621848739496,383,368,222,146,124,259,0.640479360852
17,62,0.638820638821,0.654069767442,0.686015831135,0.604838709677,0.661577608142,0.628491620112,379,372,225,147,119,260,0.645805592543
17,63,0.639225181598,0.653846153846,0.692913385827,0.597297297297,0.664987405542,0.624293785311,381,370,221,149,117,264,0.645805592543
17,64,0.622222222222,0.651162790698,0.727272727273,0.535519125683,0.670658682635,0.587706146927,385,366,196,170,105,280,0.633821571238
17,65,0.630695443645,0.655688622754,0.695767195767,0.587131367292,0.661635220126,0.619519094767,378,373,219,154,115,263,0.641810918775
17,66,0.613272311213,0.678343949045,0.726287262873,0.557591623037,0.665012406948,0.612068965517,369,382,213,169,101,268,0.640479360852
17,67,0.625,0.666666666667,0.708556149733,0.57824933687,0.664160401003,0.619318181818,374,377,218,159,109,265,0.643142476698
17,68,0.62962962963,0.652037617555,0.710182767624,0.565217391304,0.667484662577,0.605531295488,383,368,208,160,111,272,0.639147802929
17,69,0.595132743363,0.652173913043,0.721179624665,0.515873015873,0.652121212121,0.576070901034,373,378,195,183,104,269,0.617842876165
17,70,0.656992084433,0.661290322581,0.664,0.654255319149,0.660477453581,0.657754010695,375,376,246,130,126,249,0.659121171771
17,71,0.642857142857,0.669565217391,0.696,0.614361702128,0.668373879641,0.640776699029,375,376,231,145,114,261,0.655126498003
17,72,0.626477541371,0.692073170732,0.724043715847,0.58961038961,0.671736375158,0.636746143058,366,385,227,158,101,265,0.655126498003
17,73,0.615217391304,0.694158075601,0.760752688172,0.532981530343,0.680288461538,0.602985074627,372,379,202,177,89,283,0.645805592543
17,74,0.622950819672,0.663580246914,0.709333333333,0.571808510638,0.663341645885,0.614285714286,375,376,215,161,109,266,0.640479360852
17,75,0.640096618357,0.661721068249,0.699208443272,0.599462365591,0.668348045397,0.629055007052,379,372,223,149,114,265,0.649800266312
17,76,0.650602409639,0.666666666667,0.706806282723,0.607046070461,0.677540777917,0.635460992908,382,369,224,145,112,270,0.657789613848
17,77,0.635933806147,0.685975609756,0.72311827957,0.593667546174,0.676729559748,0.636492220651,372,379,225,154,103,269,0.657789613848
17,78,0.625,0.65306122449,0.681818181818,0.594164456233,0.652173913043,0.622222222222,374,377,224,153,119,255,0.637816245007
17,79,0.617073170732,0.651026392962,0.680107526882,0.585751978892,0.647058823529,0.616666666667,372,379,222,157,119,253,0.632490013316
17,80,0.614678899083,0.64126984127,0.703412073491,0.545945945946,0.65605875153,0.589781021898,381,370,202,168,113,268,0.625832223702
17,81,0.600427350427,0.643109540636,0.735602094241,0.493224932249,0.661176470588,0.558282208589,382,369,182,187,101,281,0.616511318242
17,82,0.60502283105,0.658146964856,0.712365591398,0.543535620053,0.654320987654,0.595375722543,372,379,206,173,107,265,0.627163781625
17,83,0.647058823529,0.679300291545,0.705882352941,0.618037135279,0.675191815857,0.647222222222,374,377,233,144,110,264,0.661784287617
17,84,0.657471264368,0.715189873418,0.760638297872,0.602666666667,0.705302096178,0.654124457308,376,375,226,149,90,286,0.681757656458
17,85,0.628992628993,0.654069767442,0.682666666667,0.598404255319,0.654731457801,0.625,375,376,225,151,119,256,0.640479360852
17,86,0.6725,0.672364672365,0.700520833333,0.643051771117,0.686224489796,0.657381615599,384,367,236,131,115,269,0.672436750999
17,87,0.609638554217,0.645833333333,0.680107526882,0.572559366755,0.642947903431,0.606993006993,372,379,217,162,119,253,0.625832223702
17,88,0.609649122807,0.661016949153,0.73544973545,0.522788203753,0.666666666667,0.583832335329,378,373,195,178,100,278,0.62982689747
17,89,0.611235955056,0.676470588235,0.733153638814,0.544736842105,0.666666666667,0.603498542274,371,380,207,173,99,272,0.637816245007
17,90,0.630733944954,0.666666666667,0.723684210526,0.566037735849,0.674019607843,0.612244897959,380,371,210,161,105,275,0.645805592543
17,91,0.61214953271,0.650154798762,0.698666666667,0.558510638298,0.652552926526,0.600858369099,375,376,210,166,113,262,0.628495339547
17,92,0.585972850679,0.650485436893,0.705722070845,0.5234375,0.640296662546,0.580086580087,367,384,201,183,108,259,0.612516644474
17,93,0.63723150358,0.656626506024,0.700787401575,0.589189189189,0.6675,0.621082621083,381,370,218,152,114,267,0.645805592543
17,94,0.65625,0.680597014925,0.718421052632,0.614555256065,0.685929648241,0.645892351275,380,371,228,143,107,273,0.667110519308
17,95,0.621026894866,0.666666666667,0.690217391304,0.595300261097,0.653796653797,0.628965517241,368,383,228,155,114,254,0.641810918775
17,96,0.60599078341,0.652996845426,0.70509383378,0.547619047619,0.651796778191,0.595683453237,373,378,207,171,110,263,0.625832223702
17,97,0.646370023419,0.675925925926,0.724409448819,0.591891891892,0.683168316832,0.631123919308,381,370,219,151,105,276,0.659121171771
17,98,0.620283018868,0.663608562691,0.70509383378,0.574074074074,0.659974905897,0.615602836879,373,378,217,161,110,263,0.639147802929
17,99,0.635514018692,0.668730650155,0.717678100264,0.58064516129,0.674101610905,0.621582733813,379,372,216,156,107,272,0.649800266312
19,0,0.614849187935,0.65,0.702917771883,0.55614973262,0.655940594059,0.599423631124,377,374,208,166,112,265,0.62982689747
19,1,0.603174603175,0.654838709677,0.713136729223,0.537037037037,0.653562653563,0.59011627907,373,378,203,175,107,266,0.624500665779
19,2,0.666666666667,0.713846153846,0.753315649867,0.620320855615,0.707347447073,0.663805436338,377,374,232,142,93,284,0.687083888149
19,3,0.62100456621,0.686900958466,0.735135135135,0.564304461942,0.673267326733,0.619596541787,370,381,215,166,98,272,0.648468708389
19,4,0.633569739953,0.667682926829,0.710875331565,0.585561497326,0.67,0.623931623932,377,374,219,155,109,268,0.648468708389
19,5,0.6,0.654205607477,0.69918699187,0.549738219895,0.645807259074,0.597439544808,369,382,210,172,111,258,0.623169107856
19,6,0.650632911392,0.662921348315,0.681697612732,0.631016042781,0.665803108808,0.646575342466,377,374,236,138,120,257,0.656458055925
19,7,0.639618138425,0.674698795181,0.712765957447,0.597333333333,0.674213836478,0.633663366337,376,375,224,151,108,268,0.655126498003
19,8,0.669191919192,0.695774647887,0.710455764075,0.653439153439,0.689206762029,0.673942701228,373,378,247,131,108,265,0.681757656458
19,9,0.632352941176,0.65306122449,0.684350132626,0.598930481283,0.657324840764,0.624825662483,377,374,224,150,119,258,0.641810918775
19,10,0.624129930394,0.671875,0.719251336898,0.570291777188,0.668322981366,0.616929698709,374,377,215,162,105,269,0.644474034621
19,11,0.622377622378,0.655279503106,0.706349206349,0.565683646113,0.661710037175,0.607194244604,378,373,211,162,111,267,0.636484687084
19,12,0.611111111111,0.632047477745,0.671087533156,0.569518716578,0.639696586599,0.599156118143,377,374,213,161,124,253,0.620505992011
19,13,0.631325301205,0.657738095238,0.694960212202,0.590909090909,0.661616161616,0.622535211268,377,374,221,153,115,262,0.643142476698
19,14,0.612009237875,0.660377358491,0.710455764075,0.555555555556,0.657568238213,0.603448275862,373,378,210,168,108,265,0.632490013316
19,15,0.660759493671,0.679775280899,0.696,0.643617021277,0.677922077922,0.661202185792,375,376,242,134,114,261,0.669773635153
19,16,0.603211009174,0.669841269841,0.716621253406,0.549479166667,0.65504358655,0.603719599428,367,384,211,173,104,263,0.631158455393
19,17,0.674937965261,0.686781609195,0.713910761155,0.645945945946,0.69387755102,0.66573816156,381,370,239,131,109,272,0.680426098535
19,18,0.607538802661,0.696666666667,0.750684931507,0.541450777202,0.671568627451,0.609329446064,365,386,209,177,91,274,0.643142476698
19,19,0.608108108108,0.648208469055,0.714285714286,0.533512064343,0.656934306569,0.585294117647,378,373,199,174,108,270,0.624500665779
19,20,0.627962085308,0.671732522796,0.710455764075,0.584656084656,0.666666666667,0.625176803395,373,378,221,157,108,265,0.647137150466
19,21,0.620454545455,0.665594855305,0.724137931034,0.553475935829,0.668298653611,0.604379562044,377,374,207,167,104,273,0.639147802929
19,22,0.649038461538,0.674626865672,0.712401055409,0.60752688172,0.679245283019,0.639321074965,379,372,226,146,109,270,0.660452729694
19,23,0.623529411765,0.662576687117,0.706666666667,0.574468085106,0.6625,0.615384615385,375,376,216,160,110,265,0.640479360852
19,24,0.66028708134,0.717717717718,0.745945945946,0.627296587927,0.700507614213,0.669467787115,370,381,239,142,94,276,0.685752330226
19,25,0.649289099526,0.705167173252,0.738544474394,0.610526315789,0.69104665826,0.654442877292,371,380,232,148,97,274,0.673768308921
19,26,0.64483627204,0.64406779661,0.670157068063,0.617886178862,0.657252888318,0.630705394191,382,369,228,141,126,256,0.644474034621
19,27,0.638403990025,0.654285714286,0.679045092838,0.612299465241,0.658097686375,0.632596685083,377,374,229,145,121,256,0.645805592543
19,28,0.613953488372,0.654205607477,0.704,0.558510638298,0.655900621118,0.602582496413,375,376,210,166,111,264,0.631158455393
19,29,0.610328638498,0.664615384615,0.70460704607,0.565445026178,0.654088050314,0.611032531825,369,382,216,166,109,260,0.633821571238
19,30,0.628770301624,0.66875,0.718832891247,0.572192513369,0.670792079208,0.616714697406,377,374,214,160,106,271,0.645805592543
19,31,0.63523573201,0.672413793103,0.691891891892,0.614173228346,0.662354463131,0.641975308642,370,381,234,147,114,256,0.652463382157
19,32,0.613483146067,0.673202614379,0.731903485255,0.544973544974,0.667481662592,0.602339181287,373,378,206,172,100,273,0.637816245007
19,33,0.633707865169,0.686274509804,0.746031746032,0.563002680965,0.685297691373,0.618556701031,378,373,210,163,96,282,0.655126498003
19,34,0.643031784841,0.66081871345,0.693931398417,0.60752688172,0.667512690355,0.633053221289,379,372,226,146,116,263,0.651131824234
19,35,0.652380952381,0.691842900302,0.728723404255,0.610666666667,0.688442211055,0.648725212465,376,375,229,146,102,274,0.669773635153
19,36,0.616822429907,0.650154798762,0.700265251989,0.561497326203,0.655900621118,0.602582496413,377,374,210,164,113,264,0.631158455393
19,37,0.629955947137,0.683501683502,0.752631578947,0.547169811321,0.685851318945,0.607784431138,380,371,203,168,94,286,0.651131824234
19,38,0.612195121951,0.639296187683,0.671122994652,0.57824933687,0.640306122449,0.607242339833,374,377,218,159,123,251,0.624500665779
19,39,0.63981042654,0.696048632219,0.72972972973,0.601049868766,0.681818181818,0.645070422535,370,381,229,152,100,270,0.664447403462
19,40,0.646191646192,0.65988372093,0.692105263158,0.611859838275,0.668360864041,0.634965034965,380,371,227,144,117,263,0.652463382157
19,41,0.611111111111,0.652037617555,0.704,0.553191489362,0.654275092937,0.598561151079,375,376,208,168,111,264,0.628495339547
19,42,0.636828644501,0.641666666667,0.65873015873,0.619302949062,0.647594278283,0.630286493861,378,373,231,142,129,249,0.639147802929
19,43,0.626728110599,0.681388012618,0.729222520107,0.571428571429,0.674101610905,0.621582733813,373,378,216,162,101,272,0.649800266312
19,44,0.643031784841,0.654970760234,0.690288713911,0.605405405405,0.66582278481,0.629213483146,381,370,224,146,118,263,0.648468708389
19,45,0.615711252654,0.696428571429,0.773333333333,0.518617021277,0.685579196217,0.594512195122,375,376,195,181,85,290,0.645805592543
19,46,0.661616161616,0.664788732394,0.687664041995,0.637837837838,0.674388674389,0.651034482759,381,370,236,134,119,262,0.663115845539
19,47,0.660049627792,0.672413793103,0.7,0.630727762803,0.679438058748,0.65090403338,380,371,234,137,114,266,0.665778961385
19,48,0.650485436893,0.663716814159,0.701570680628,0.609756097561,0.675062972292,0.635593220339,382,369,225,144,114,268,0.656458055925
19,49,0.600446428571,0.660066006601,0.72311827957,0.527704485488,0.656097560976,0.58651026393,372,379,200,179,103,269,0.624500665779
19,50,0.602836879433,0.637195121951,0.681818181818,0.554376657825,0.639899623588,0.592907801418,374,377,209,168,119,255,0.617842876165
19,51,0.633257403189,0.676282051282,0.733509234828,0.567204301075,0.679706601467,0.616959064327,379,372,211,161,101,278,0.651131824234
19,52,0.611587982833,0.687719298246,0.762032085561,0.519893899204,0.678571428571,0.592145015106,374,377,196,181,89,285,0.640479360852
19,53,0.640586797066,0.654970760234,0.689473684211,0.603773584906,0.664131812421,0.628330995792,380,371,224,147,118,262,0.647137150466
19,54,0.604166666667,0.66144200627,0.707317073171,0.552356020942,0.651685393258,0.601997146933,369,382,211,171,108,261,0.628495339547
19,55,0.619815668203,0.665615141956,0.717333333333,0.561170212766,0.665018541409,0.608946608947,375,376,211,165,106,269,0.639147802929
19,56,0.624145785877,0.673076923077,0.728723404255,0.56,0.672392638037,0.61135371179,376,375,210,165,102,274,0.644474034621
19,57,0.619512195122,0.636363636364,0.671957671958,0.581769436997,0.644670050761,0.607843137255,378,373,217,156,124,254,0.627163781625
19,58,0.637037037037,0.676300578035,0.697297297297,0.614173228346,0.665806451613,0.643741403026,370,381,234,147,112,258,0.655126498003
19,59,0.607305936073,0.645367412141,0.705570291777,0.540106951872,0.652760736196,0.588064046579,377,374,202,172,111,266,0.623169107856
19,60,0.661971830986,0.698461538462,0.742105263158,0.611859838275,0.699751861042,0.652298850575,380,371,227,144,98,282,0.67776298269
19,61,0.627160493827,0.664739884393,0.686486486486,0.603674540682,0.655483870968,0.632737276479,370,381,230,151,116,254,0.644474034621
19,62,0.629268292683,0.656891495601,0.688,0.595744680851,0.657324840764,0.624825662483,375,376,224,152,117,258,0.641810918775
19,63,0.628640776699,0.654867256637,0.688829787234,0.592,0.657360406091,0.621848739496,376,375,222,153,117,259,0.640479360852
19,64,0.621247113164,0.669811320755,0.719251336898,0.564986737401,0.666666666667,0.612949640288,374,377,213,164,105,269,0.641810918775
19,65,0.631707317073,0.653958944282,0.68700265252,0.596256684492,0.658195679797,0.623776223776,377,374,223,151,118,259,0.641810918775
19,66,0.661764705882,0.68221574344,0.712401055409,0.629032258065,0.686149936468,0.654545454545,379,372,234,138,109,270,0.671105193076
19,67,0.630136986301,0.67731629393,0.732095490716,0.566844919786,0.677300613497,0.617176128093,377,374,212,162,101,276,0.649800266312
19,68,0.629716981132,0.672782874618,0.713903743316,0.583554376658,0.669172932331,0.625,374,377,220,157,107,267,0.648468708389
19,69,0.659949622166,0.655367231638,0.682291666667,0.632152588556,0.670934699104,0.643550624133,384,367,232,135,122,262,0.657789613848
19,70,0.647191011236,0.725490196078,0.774193548387,0.585751978892,0.705018359853,0.648175182482,372,379,222,157,84,288,0.679094540613
19,71,0.626398210291,0.700657894737,0.754716981132,0.560526315789,0.684596577017,0.622807017544,371,380,213,167,91,280,0.656458055925
19,72,0.639423076923,0.671641791045,0.707446808511,0.6,0.671717171717,0.633802816901,376,375,225,150,110,266,0.65379494008
19,73,0.634482758621,0.70253164557,0.745945945946,0.582677165354,0.685714285714,0.637015781923,370,381,222,159,94,276,0.663115845539
19,74,0.669064748201,0.715568862275,0.745989304813,0.633952254642,0.705436156764,0.67229254571,374,377,239,138,95,279,0.689747003995
19,75,0.632603406326,0.661764705882,0.693333333333,0.598404255319,0.661577608142,0.628491620112,375,376,225,151,115,260,0.645805592543
19,76,0.663438256659,0.698224852071,0.728723404255,0.629333333333,0.694550063371,0.661991584853,376,375,236,139,102,274,0.679094540613
19,77,0.651551312649,0.704819277108,0.735849056604,0.615789473684,0.691139240506,0.657303370787,371,380,234,146,98,273,0.675099866844
19,78,0.637931034483,0.669565217391,0.69436997319,0.611111111111,0.664955070603,0.639004149378,373,378,231,147,114,259,0.652463382157
19,79,0.664041994751,0.645945945946,0.658854166667,0.651226158038,0.661437908497,0.648575305292,384,367,239,128,131,253,0.655126498003
19,80,0.657568238213,0.666666666667,0.695538057743,0.627027027027,0.676020408163,0.646239554318,381,370,232,138,116,265,0.661784287617
19,81,0.644230769231,0.698507462687,0.726287262873,0.612565445026,0.682802547771,0.652719665272,369,382,234,148,101,268,0.66844207723
19,82,0.600472813239,0.625,0.67374005305,0.548128342246,0.635,0.584045584046,377,374,205,169,123,254,0.611185086551
19,83,0.637209302326,0.688473520249,0.732620320856,0.586206896552,0.681592039801,0.63323782235,374,377,221,156,100,274,0.659121171771
19,84,0.634743875278,0.695364238411,0.755968169761,0.561497326203,0.690072639225,0.621301775148,377,374,210,164,92,285,0.659121171771
19,85,0.622685185185,0.673981191223,0.721179624665,0.568783068783,0.668322981366,0.616929698709,373,378,215,163,104,269,0.644474034621
19,86,0.639534883721,0.691588785047,0.735294117647,0.588859416446,0.68407960199,0.636103151862,374,377,222,155,99,275,0.661784287617
19,87,0.683377308707,0.674731182796,0.681578947368,0.676549865229,0.682476943347,0.675639300135,380,371,251,120,121,259,0.679094540613
19,88,0.672985781991,0.689969604863,0.735751295337,0.621917808219,0.70297029703,0.654178674352,386,365,227,138,102,284,0.680426098535
19,89,0.631828978622,0.669696969697,0.709333333333,0.587765957447,0.668341708543,0.626062322946,375,376,221,155,109,266,0.648468708389
19,90,0.619815668203,0.643533123028,0.704188481675,0.552845528455,0.65931372549,0.594752186589,382,369,204,165,113,269,0.62982689747
19,91,0.619952494062,0.669696969697,0.705405405405,0.580052493438,0.65992414665,0.621659634318,370,381,221,160,109,261,0.641810918775
19,92,0.624444444444,0.697674418605,0.755376344086,0.554089709763,0.683698296837,0.617647058824,372,379,210,169,91,281,0.65379494008
19,93,0.619589977221,0.660256410256,0.719576719577,0.552278820375,0.665850673195,0.601459854015,378,373,206,167,106,272,0.636484687084
19,94,0.632318501171,0.66049382716,0.710526315789,0.576819407008,0.669144981413,0.615827338129,380,371,214,157,110,270,0.644474034621
19,95,0.619277108434,0.642857142857,0.681697612732,0.577540106952,0.64898989899,0.608450704225,377,374,216,158,120,257,0.62982689747
19,96,0.640371229698,0.6875,0.734042553191,0.586666666667,0.684014869888,0.63309352518,376,375,220,155,100,276,0.660452729694
19,97,0.615384615385,0.659701492537,0.691891891892,0.580052493438,0.651399491094,0.617318435754,370,381,221,160,114,256,0.635153129161
19,98,0.608695652174,0.640127388535,0.701846965699,0.540322580645,0.651960784314,0.586005830904,379,372,201,171,113,266,0.621837549933
19,99,0.650602409639,0.675595238095,0.712401055409,0.610215053763,0.680100755668,0.641242937853,379,372,227,145,109,270,0.661784287617
