DEEP MAX,K,#Exec,PPV_S,PPV_NS,TPR_S,TPR_NS,F1_S,F1_NS,SUP_S,SUP_NS,TN,FP,FN,TP,Acc,Deep,Training Time
40,9,1,0.0,0.5121951219512195,0.0,1.0,0.0,0.6774193548387097,200,210,210,0,200,0,0.5121951219512195,1,1061.8749089241028
40,5,1,0.0,0.5,0.0,1.0,0.0,0.6666666666666666,205,205,205,0,205,0,0.5,22,3483.854965686798
40,3,1,0.9298245614035088,0.5552407932011332,0.2523809523809524,0.98,0.39700374531835203,0.7088607594936709,210,200,196,4,157,53,0.6073170731707317,39,4219.160367965698
40,5,2,0.9135802469135802,0.601823708206687,0.36097560975609755,0.9658536585365853,0.5174825174825175,0.7415730337078651,205,205,198,7,131,74,0.6634146341463415,39,15973.012848615646
40,9,2,0.987012987012987,0.6006006006006006,0.36363636363636365,0.9950248756218906,0.5314685314685316,0.749063670411985,209,201,200,1,133,76,0.6731707317073171,40,19149.679979085922
40,5,3,0.0,0.5,0.0,1.0,0.0,0.6666666666666666,205,205,205,0,205,0,0.5,1,1056.5448276996613
40,7,1,0.956989247311828,0.637223974763407,0.4362745098039216,0.9805825242718447,0.5993265993265994,0.7724665391969407,204,206,202,4,115,89,0.7097560975609756,38,22116.007810354233
40,9,3,0.9583333333333334,0.6035502958579881,0.3399014778325123,0.9855072463768116,0.5018181818181818,0.7486238532110092,203,207,204,3,134,69,0.6658536585365854,36,8587.055956840515
40,7,2,0.9615384615384616,0.6699346405228758,0.4975124378109453,0.9808612440191388,0.6557377049180327,0.7961165048543689,201,209,205,4,101,100,0.7439024390243902,40,13498.93096280098
40,7,3,0.0,0.4951219512195122,0.0,1.0,0.0,0.6623164763458401,207,203,203,0,207,0,0.4951219512195122,1,1176.5456249713898
40,7,4,0.0,0.4658536585365854,0.0,1.0,0.0,0.6356073211314477,219,191,191,0,219,0,0.4658536585365854,1,1051.2472381591797
40,3,2,0.8518518518518519,0.6324503311258278,0.45320197044334976,0.9227053140096618,0.5916398713826366,0.7504911591355601,203,207,191,16,111,92,0.6902439024390243,40,33930.43475675583
40,5,4,0.9719626168224299,0.6435643564356436,0.49056603773584906,0.9848484848484849,0.6520376175548589,0.778443113772455,212,198,195,3,108,104,0.7292682926829268,31,21612.100306272507
40,3,3,1.0,0.5333333333333333,0.16666666666666666,1.0,0.2857142857142857,0.6956521739130436,210,200,200,0,175,35,0.573170731707317,40,5343.428213596344
40,3,4,0.8813559322033898,0.6712328767123288,0.52,0.9333333333333333,0.6540880503144655,0.7808764940239045,200,210,196,14,96,104,0.7317073170731707,39,7729.798535108566
40,9,4,0.9514563106796117,0.6514657980456026,0.47804878048780486,0.975609756097561,0.6363636363636364,0.78125,205,205,200,5,107,98,0.7268292682926829,40,24356.173166036606
40,3,5,0.0,0.5195121951219512,0.0,1.0,0.0,0.6837881219903692,197,213,213,0,197,0,0.5195121951219512,36,4105.507467031479
40,5,5,0.9824561403508771,0.6722972972972973,0.5358851674641149,0.9900497512437811,0.6934984520123839,0.8008048289738431,209,201,199,2,97,112,0.7585365853658537,38,21091.073001384735
40,3,6,0.9327731092436975,0.6735395189003437,0.5388349514563107,0.9607843137254902,0.683076923076923,0.791919191919192,206,204,196,8,95,111,0.748780487804878,40,7996.691430568695
40,5,6,0.0,0.4902439024390244,0.0,1.0,0.0,0.6579378068739771,209,201,201,0,209,0,0.4902439024390244,1,1036.353630065918
40,7,5,0.9444444444444444,0.6556291390728477,0.49514563106796117,0.9705882352941176,0.6496815286624203,0.7826086956521738,206,204,198,6,104,102,0.7317073170731707,40,27348.834280490875
40,7,6,0.978494623655914,0.6403785488958991,0.44390243902439025,0.9902439024390244,0.610738255033557,0.7777777777777778,205,205,203,2,114,91,0.7170731707317073,40,25991.82012963295
40,7,7,0.0,0.5097560975609756,0.0,1.0,0.0,0.6752827140549273,201,209,209,0,201,0,0.5097560975609756,1,1044.2054147720337
40,3,7,1.0,0.639751552795031,0.43137254901960786,1.0,0.6027397260273972,0.7803030303030303,204,206,206,0,116,88,0.7170731707317073,40,31290.06847167015
40,5,7,1.0,0.5521126760563381,0.2570093457943925,1.0,0.40892193308550184,0.7114337568058076,214,196,196,0,159,55,0.6121951219512195,39,36630.615547180176
40,5,8,0.0,0.4926829268292683,0.0,1.0,0.0,0.6601307189542484,208,202,202,0,208,0,0.4926829268292683,1,1032.2730882167816
40,5,9,0.0,0.5024390243902439,0.0,1.0,0.0,0.6688311688311689,204,206,206,0,204,0,0.5024390243902439,1,1070.2319452762604
40,5,10,0.0,0.5097560975609756,0.0,1.0,0.0,0.6752827140549273,201,209,209,0,201,0,0.5097560975609756,1,1071.5230913162231
40,9,5,0.9838709677419355,0.603448275862069,0.3065326633165829,0.995260663507109,0.46743295019157094,0.7513416815742398,199,211,210,1,138,61,0.6609756097560976,39,78056.49681305885
40,9,6,0.0,0.5097560975609756,0.0,1.0,0.0,0.6752827140549273,201,209,209,0,201,0,0.5097560975609756,1,1026.3416719436646
40,3,8,0.9296875,0.7021276595744681,0.5862068965517241,0.9565217391304348,0.7190332326283987,0.8098159509202454,203,207,198,9,84,119,0.7731707317073171,36,38364.531549453735
40,9,7,0.9727272727272728,0.69,0.535,0.9857142857142858,0.6903225806451613,0.8117647058823529,200,210,207,3,93,107,0.7658536585365854,40,16934.551809072495
40,9,8,0.0,0.5,0.0,1.0,0.0,0.6666666666666666,205,205,205,0,205,0,0.5,1,1030.9160358905792
40,7,8,0.9340659340659341,0.6300940438871473,0.4187192118226601,0.9710144927536232,0.5782312925170068,0.7642585551330798,203,207,201,6,118,85,0.697560975609756,40,62568.582041502
40,7,9,0.0,0.4853658536585366,0.0,1.0,0.0,0.6535303776683087,211,199,199,0,211,0,0.4853658536585366,36,3702.761521100998
40,7,10,0.0,0.5,0.0,1.0,0.0,0.6666666666666666,205,205,205,0,205,0,0.5,36,1967.0059275627136
40,3,9,0.937984496124031,0.697508896797153,0.587378640776699,0.9607843137254902,0.7223880597014926,0.8082474226804123,206,204,196,8,85,121,0.7731707317073171,40,42957.28677511215
40,9,9,1.0,0.5988200589970502,0.34299516908212563,1.0,0.5107913669064749,0.7490774907749077,207,203,203,0,136,71,0.6682926829268293,38,33347.72946476936
40,9,10,0.9230769230769231,0.6144200626959248,0.4057971014492754,0.9655172413793104,0.5637583892617449,0.7509578544061303,207,203,196,7,123,84,0.6829268292682927,38,4882.1955099105835
40,3,10,0.8888888888888888,0.7105263157894737,0.624390243902439,0.9219512195121952,0.7335243553008596,0.8025477707006369,205,205,189,16,77,128,0.7731707317073171,37,24565.26840019226
